"Uni"	"City"
"A.T. Still University of Health Sciences"	"Kirksville, MO"
"Aaniiih Nakoda College"	"Harlem, MT"
"Abcott Institute"	"Southfield, MI"
"Abraham Baldwin Agricultural College"	"Tifton, GA"
"Academy at Austin"	"Pflugerville, TX"
"Academy College"	"Minneapolis, MN"
"Academy for Practical Nursing & Health Occupations"	"West Palm Beach, FL"
"Academy of Career Training"	"Kissimmee, FL"
"Academy of Careers and Technology"	"Beckley, WV"
"Academy of Chinese Culture and Health Sciences"	"Oakland, CA"
"Academy of Cosmetology - FL"	"Merritt Island, FL"
"Academy of Cosmetology and Esthetics NYC"	"Staten Island, NY"
"Academy of Hair Design-Poway"	"Poway, CA"
"Academy of Hair Technology"	"Greenville, SC"
"Academy of Nail Skin and Hair"	"Billings, MT"
"Academy of Oriental Medicine at Austin"	"Austin, TX"
"Academy of Salon Professionals"	"Sedalia, MO"
"The Academy Waukesha"	"Waukesha, WI"
"Ace Computer Training Center"	"Forest Hills, NY"
"Ace Cosmetology and Barber Training Center"	"Wolcott, CT"
"Acupuncture and Integrative Medicine College-Berkeley"	"Berkeley, CA"
"Acupuncture and Massage College"	"Miami, FL"
"Adams State University"	"Alamosa, CO"
"Adirondack Community College"	"Queensbury, NY"
"Adrian College"	"Adrian, MI"
"Adrians Beauty College of Turlock"	"Turlock, CA"
"Adult & Continuing Education-BCTS"	"Hackensack, NJ"
"Adult and Community Education-Hudson"	"Columbus, OH"
"Adult Center for Education"	"Zanesville, OH"
"Advance Beauty College"	"Garden Grove, CA"
"Advanced Technology Institute"	"Virginia Beach, VA"
"Advanced Training Institute"	"Las Vegas, NV"
"AdventHealth University"	"Orlando, FL"
"Agnes Scott College"	"Decatur, GA"
"Aiken Technical College"	"Graniteville, SC"
"Aims Community College"	"Greeley, CO"
"Air Force Institute of Technology"	"Wright Patterson, OH"
"Alabama A & M University"	"Normal, AL"
"Alabama State University"	"Montgomery, AL"
"Alameda Beauty College"	"Alameda, CA"
"Alaska Career College"	"Anchorage, AK"
"Alaska Pacific University"	"Anchorage, AK"
"Albany BOCES-Adult Practical Nursing Program"	"Albany, NY"
"Albany College of Pharmacy and Health Sciences"	"Albany, NY"
"Albany Law School"	"Albany, NY"
"Albany Medical College"	"Albany, NY"
"Albany State University"	"Albany, GA"
"Albany Technical College"	"Albany, GA"
"Albion College"	"Albion, MI"
"Albright College"	"Reading, PA"
"Alcorn State University"	"Alcorn State, MS"
"Alderson Broaddus University"	"Philippi, WV"
"Alexandria Technical and Community College"	"Alexandria, MN"
"Alfred University"	"Alfred, NY"
"Alhambra Beauty College"	"Alhambra, CA"
"Alice Lloyd College"	"Pippa Passes, KY"
"Allan Hancock College"	"Santa Maria, CA"
"Allegheny College"	"Meadville, PA"
"Allen College"	"Waterloo, IA"
"Allen University"	"Columbia, SC"
"Alliant International University"	"San Diego, CA"
"Allstate Commercial Driver Training"	"Seymour, CT"
"Alma College"	"Alma, MI"
"Alpena Community College"	"Alpena, MI"
"Altoona Beauty School Inc"	"Altoona, PA"
"Alvernia University"	"Reading, PA"
"Alverno College"	"Milwaukee, WI"
"Alvin Community College"	"Alvin, TX"
"Amberton University"	"Garland, TX"
"Ambria College of Nursing"	"Hanover Park, IL"
"American Academy of Art"	"Chicago, IL"
"American Academy of Cosmetology"	"Orange Park, FL"
"American Advanced Technicians Institute"	"Hialeah, FL"
"American Baptist College"	"Nashville, TN"
"American Beauty School"	"Bronx, NY"
"American College for Medical Careers"	"Orlando, FL"
"American College of Acupuncture and Oriental Med"	"Houston, TX"
"American College of Education"	"Chicago, IL"
"American College of Financial Services"	"Bryn Mawr, PA"
"American College of Healthcare Sciences"	"Portland, OR"
"American Indian OIC Inc"	"Minneapolis, MN"
"American Institute-Toms River"	"Toms River, NJ"
"American International College"	"Springfield, MA"
"American Jewish University"	"Los Angeles, CA"
"American Medical Academy"	"Miami, FL"
"American Public University System"	"Charles Town, WV"
"American River College"	"Sacramento, CA"
"American Samoa Community College"	"Pago Pago, AS"
"American School of Nursing and Medical Careers"	"Manchester, NH"
"American University of Health Sciences"	"Signal Hill, CA"
"Amherst College"	"Amherst, MA"
"Amridge University"	"Montgomery, AL"
"Ancilla College"	"Donaldson, IN"
"Anderson University - IN"	"Anderson, IN"
"Anderson University - SC"	"Anderson, SC"
"Andrew College"	"Cuthbert, GA"
"Andrews University"	"Berrien Springs, MI"
"Angeles Institute"	"Lakewood, CA"
"Angelina College"	"Lufkin, TX"
"Angelo State University"	"San Angelo, TX"
"Anne Arundel Community College"	"Arnold, MD"
"Anoka Technical College"	"Anoka, MN"
"Anoka-Ramsey Community College"	"Coon Rapids, MN"
"Antelope Valley College"	"Lancaster, CA"
"Anthem College - Bryman School"	"Phoenix, AZ"
"Antioch College"	"Yellow Springs, OH"
"Antioch University-Los Angeles"	"Culver City, CA"
"Antioch University-Midwest"	"Yellow Springs, OH"
"Antioch University-New England"	"Keene, NH"
"Antioch University-PhD Program in Leadership and Change"	"Yellow Springs, OH"
"Antioch University-Santa Barbara"	"Santa Barbara, CA"
"Antioch University-Seattle"	"Seattle, WA"
"Apex School of Theology"	"Durham, NC"
"Apex Technical School"	"New York, NY"
"Apollo Career Center"	"Lima, OH"
"Appalachian College of Pharmacy"	"Oakwood, VA"
"Appalachian School of Law"	"Grundy, VA"
"Appalachian State University"	"Boone, NC"
"Applied Technology Services"	"Sunset Hills, MO"
"Aquinas College - MI"	"Grand Rapids, MI"
"Aquinas Institute of Theology"	"St. Louis, MO"
"Arcadia University"	"Glenside, PA"
"Aria Health School of Nursing"	"Philadelphia, PA"
"Arizona Academy of Beauty-East"	"Tucson, AZ"
"Arizona Automotive Institute"	"Glendale, AZ"
"Arizona Christian University"	"Phoenix, AZ"
"Arizona College-Mesa"	"Mesa, AZ"
"Arkansas Baptist College"	"Little Rock, AR"
"Arkansas State University Three Rivers"	"Malvern, AR"
"Arkansas State University-Mountain Home"	"Mountain Home, AR"
"Arkansas Tech University"	"Russellville, AR"
"Arlington Baptist College"	"Arlington, TX"
"Arlington Career Institute"	"Grand Prairie, TX"
"Arrojo Cosmetology School"	"New York, NY"
"Art Academy of Cincinnati"	"Cincinnati, OH"
"Art Center College of Design"	"Pasadena, CA"
"Artistic Academy of Hair Design"	"Morris Plains, NJ"
"Asbury Theological Seminary"	"Wilmore, KY"
"Asbury University"	"Wilmore, KY"
"Ashland Community and Technical College"	"Ashland, KY"
"Ashland University"	"Ashland, OH"
"Ashtabula County Joint Vocational School"	"Jefferson, OH"
"Asian American International Beauty College"	"Westminster, CA"
"ASM Beauty World Academy"	"Davie, FL"
"Asnuntuck Community College"	"Enfield, CT"
"Aspen Beauty Academy of Laurel"	"Laurel, MD"
"Associated Technical College-Los Angeles"	"Los Angeles, CA"
"Associated Technical College-San Diego"	"San Diego, CA"
"ATA College"	"Louisville, KY"
"Athena Career Academy"	"Sylvania, OH"
"Athens State University"	"Athens, AL"
"Athens Technical College"	"Athens, GA"
"Atlanta Metropolitan State College"	"Atlanta, GA"
"Atlanta School of Massage"	"Atlanta, GA"
"Atlanta Technical College"	"Atlanta, GA"
"Atlanta's John Marshall Law School"	"Atlanta, GA"
"Atlantic Beauty & Spa Academy LLC"	"Pleasantville, NJ"
"Atlantic Cape Community College"	"Mays Landing, NJ"
"Atlantic Institute of Oriental Medicine"	"Fort Lauderdale, FL"
"ATS Institute of Technology"	"Highland Heights, OH"
"Auburn Career Center"	"Concord Twp, OH"
"Auburn University"	"Auburn, AL"
"Auburn University at Montgomery"	"Montgomery, AL"
"Augsburg University"	"Minneapolis, MN"
"Augusta University"	"Augusta, GA"
"Augustana College - IL"	"Rock Island, IL"
"Augustana University - SD"	"Sioux Falls, SD"
"Aultman College of Nursing and Health Sciences"	"Canton, OH"
"Aurora University"	"Aurora, IL"
"Austin College"	"Sherman, TX"
"Austin Kade Academy"	"Idaho Falls, ID"
"Autry Technology Center"	"Enid, OK"
"Avalon School of Cosmetology-Layton"	"Layton, UT"
"Avalon School of Cosmetology-Phoenix"	"Phoenix, AZ"
"Ave Maria School of Law"	"Naples, FL"
"Ave Maria University"	"Ave Maria, FL"
"Aveda Institute Des Moines"	"West Des Moines, IA"
"Aveda Institute of New Mexico (The)"	"Albuquerque, NM"
"Aveda Institute Portland"	"Portland, OR"
"Aveda Institute Tucson"	"Tucson, AZ"
"Avenue Five Institute"	"Austin, TX"
"Aviation Institute of Maintenance-Las Vegas"	"Las Vegas, NV"
"Aviator College of Aeronautical Science and Technology"	"Fort Pierce, FL"
"Avila University"	"Kansas City, MO"
"AVTEC-Alaska's Institute of Technology"	"Seward, AK"
"Award Beauty School"	"Hagerstown, MD"
"Ayers Career College"	"Shreveport, LA"
"Azusa Pacific University"	"Azusa, CA"
"Bacone College"	"Muskogee, OK"
"Baker College of Cadillac"	"Cadillac, MI"
"Baker College of Clinton Township"	"Clinton Township, MI"
"Baker College of Flint"	"Flint, MI"
"Baker College of Jackson"	"Jackson, MI"
"Baker College of Muskegon"	"Muskegon, MI"
"Baker College of Owosso"	"Owosso, MI"
"Bakke Graduate University"	"Dallas, TX"
"Baldwin Beauty School-North Austin"	"Austin, TX"
"Baldwin Park Adult & Community Education"	"Baldwin Park, CA"
"Baldwin Wallace University"	"Berea, OH"
"Ball State University"	"Muncie, IN"
"Baltimore City Community College"	"Baltimore, MD"
"Bank Street College of Education"	"New York, NY"
"Baptist Bible College and Graduate School"	"Springfield, MO"
"The Baptist College of Florida"	"Graceville, FL"
"Baptist Health Schools-Little Rock"	"Little Rock, AR"
"Baptist Health System School of Health Professions"	"San Antonio, TX"
"Baptist Memorial College of Health Sciences"	"Memphis, TN"
"Baptist University of the Americas"	"San Antonio, TX"
"Barclay College"	"Haviland, KS"
"Bard College"	"Annandale-On-Hudson, NY"
"Bard College at Simon's Rock"	"Great Barrington, MA"
"Barnard College"	"New York, NY"
"Barnes-Jewish College Goldfarb School of Nursing"	"St. Louis, MO"
"Barstow Community College"	"Barstow, CA"
"Barton College"	"Wilson, NC"
"Barton County Community College"	"Great Bend, KS"
"Bastyr University"	"Kenmore, WA"
"Bates College"	"Lewiston, ME"
"Bates Technical College"	"Tacoma, WA"
"Baton Rouge Community College"	"Baton Rouge, LA"
"Bay de Noc Community College"	"Escanaba, MI"
"Bay Mills Community College"	"Brimley, MI"
"Baylor College of Medicine"	"Houston, TX"
"Beacon College"	"Leesburg, FL"
"Beal College"	"Bangor, ME"
"Beaufort County Community College"	"Washington, NC"
"Beaumont Adult School"	"Beaumont, CA"
"Beauty Academy of South Florida"	"Hialeah, FL"
"Beck Area Career Center-Red Bud"	"Red Bud, IL"
"Becker College"	"Worcester, MA"
"Beckfield College"	"Florence, KY"
"Bel-Rea Institute of Animal Technology"	"Denver, CO"
"Belanger School of Nursing"	"Schenectady, NY"
"Belhaven University"	"Jackson, MS"
"Bellarmine University"	"Louisville, KY"
"Belle Academy of Cosmetology"	"Waterbury, CT"
"Bellevue College"	"Bellevue, WA"
"Bellin College"	"Green Bay, WI"
"Bellingham Technical College"	"Bellingham, WA"
"Bellus Academy"	"Manhattan, KS"
"Belmont Abbey College"	"Belmont, NC"
"Belmont College"	"St. Clairsville, OH"
"Belmont University"	"Nashville, TN"
"Beloit College"	"Beloit, WI"
"Bemidji State University"	"Bemidji, MN"
"Ben Franklin Career Center"	"Dunbar, WV"
"Benedict College"	"Columbia, SC"
"Benedictine College"	"Atchison, KS"
"Benes International School of Beauty"	"New Port Richey, FL"
"Benjamin Franklin Institute of Technology"	"Boston, MA"
"Bennett Career Institute"	"Washington D.C., DC"
"Bennett College"	"Greensboro, NC"
"Bennington College"	"Bennington, VT"
"Bentley University"	"Waltham, MA"
"Berea College"	"Berea, KY"
"Bergen Community College"	"Paramus, NJ"
"Berkeley City College"	"Berkeley, CA"
"Berklee College of Music"	"Boston, MA"
"Berks Career & Technology Center"	"Leesport, PA"
"Berks Technical Institute"	"Wyomissing, PA"
"Berkshire Community College"	"Pittsfield, MA"
"Berry College"	"Mount Berry, GA"
"Bethany College - KS"	"Lindsborg, KS"
"Bethany College - WV"	"Bethany, WV"
"Bethany Lutheran College"	"Mankato, MN"
"Bethel College - KS"	"North Newton, KS"
"Bethel Seminary San Diego"	"San Diego, CA"
"Bethel University - IN"	"Mishawaka, IN"
"Bethel University - MN"	"Saint Paul, MN"
"Bethel University - TN"	"McKenzie, TN"
"Bethesda University"	"Anaheim, CA"
"Bethune-Cookman University"	"Daytona Beach, FL"
"Beulah Heights University"	"Atlanta, GA"
"Bidwell Training Center Inc"	"Pittsburgh, PA"
"Big Bend Community College"	"Moses Lake, WA"
"Big Sandy Community and Technical College"	"Prestonsburg, KY"
"Biola University"	"La Mirada, CA"
"Birmingham Southern College"	"Birmingham, AL"
"Bishop State Community College"	"Mobile, AL"
"Bismarck State College"	"Bismarck, ND"
"BJ's Beauty & Barber College"	"Tacoma, WA"
"Black Hawk College"	"Moline, IL"
"Black Hills Beauty College"	"Rapid City, SD"
"Black Hills State University"	"Spearfish, SD"
"Black River Technical College"	"Pocahontas, AR"
"Blackburn College"	"Carlinville, IL"
"Blackfeet Community College"	"Browning, MT"
"Blackhawk Technical College"	"Janesville, WI"
"Bladen Community College"	"Dublin, NC"
"Blake Austin College"	"Vacaville, CA"
"Blake Austin College Beauty Academy"	"Vacaville, CA"
"Blessing Rieman College of Nursing"	"Quincy, IL"
"Blinn College"	"Brenham, TX"
"Bloomfield College"	"Bloomfield, NJ"
"Bloomsburg University of Pennsylvania"	"Bloomsburg, PA"
"Blue Mountain College"	"Blue Mountain, MS"
"Blue Mountain Community College"	"Pendleton, OR"
"Blue Ridge Community and Technical College"	"Martinsburg, WV"
"Blue Ridge Community College - NC"	"Flat Rock, NC"
"Blue Ridge Community College - VA"	"Weyers Cave, VA"
"Bluefield College"	"Bluefield, VA"
"Bluefield State College"	"Bluefield, WV"
"Bluegrass Community and Technical College"	"Lexington, KY"
"Bluffton University"	"Bluffton, OH"
"Bob Jones University"	"Greenville, SC"
"Boca Beauty Academy"	"Boca Raton, FL"
"Boise Bible College"	"Boise, ID"
"Bon Secours Memorial College of Nursing"	"Richmond, VA"
"Bonnie Joseph Academy of Cosmetology and Barbering"	"Heber City, UT"
"Boricua College"	"New York, NY"
"Bossier Parish Community College"	"Bossier City, LA"
"Boston Architectural College"	"Boston, MA"
"Boston College"	"Chestnut Hill, MA"
"Boston Graduate School of Psychoanalysis Inc"	"Brookline, MA"
"Boston University - Business"	"Boston, MA"
"Bowdoin College"	"Brunswick, ME"
"Bowie State University"	"Bowie, MD"
"Bradford-Union Area Career Technical Center"	"Starke, FL"
"Brandeis University"	"Waltham, MA"
"Brazosport College"	"Lake Jackson, TX"
"Brevard College"	"Brevard, NC"
"Brewster Technical College"	"Tampa, FL"
"Brewton-Parker College"	"Mount Vernon, GA"
"Briar Cliff University"	"Sioux City, IA"
"Bridgewater College"	"Bridgewater, VA"
"Bridgewater State University"	"Bridgewater, MA"
"Brigham Young University"	"Provo, UT"
"Brigham Young University - Idaho"	"Rexburg, ID"
"Brigham Young University-Hawaii"	"Laie, HI"
"Bristol Community College"	"Fall River, MA"
"Brite Divinity School"	"Fort Worth, TX"
"Broadview Entertainment Arts University"	"Salt Lake City, UT"
"Brookdale Community College"	"Lincroft, NJ"
"Brooklyn Law School"	"Brooklyn, NY"
"Broome Community College"	"Binghamton, NY"
"Broward College"	"Fort Lauderdale, FL"
"Brown University"	"Providence, RI"
"Brunswick Community College"	"Bolivia, NC"
"Bryan College - Dayton"	"Dayton, TN"
"Bryan College of Health Sciences"	"Lincoln, NE"
"Bryan University - AR"	"Rogers, AR"
"Bryan University - MO"	"Springfield, MO"
"Bryant & Stratton College-Akron"	"Copley, OH"
"Bryant University"	"Smithfield, RI"
"Bryn Athyn College of the New Church"	"Bryn Athyn, PA"
"Bryn Mawr College"	"Bryn Mawr, PA"
"Buckeye Career Center"	"New Philadelphia, OH"
"Bucknell University"	"Lewisburg, PA"
"Bucks County Community College"	"Newtown, PA"
"Buena Vista University"	"Storm Lake, IA"
"Bunker Hill Community College"	"Boston, MA"
"Butler Community College"	"El Dorado, KS"
"Butler Tech-D Russel Lee Career Center"	"Hamilton, OH"
"Butler University"	"Indianapolis, IN"
"Butte College"	"Oroville, CA"
"Cabarrus College of Health Sciences"	"Concord, NC"
"Cabell County Career Technology Center"	"Huntington, WV"
"Cabrillo College"	"Aptos, CA"
"Cabrini University"	"Radnor, PA"
"Caddo Kiowa Technology Center"	"Fort Cobb, OK"
"Cairn University"	"Langhorne, PA"
"CALC Institute of Technology"	"Alton, IL"
"Caldwell Community College and Technical Institute"	"Hudson, NC"
"Caldwell University"	"Caldwell, NJ"
"California Academy-A Paul Mitchell Partner School"	"Sacramento, CA"
"California Beauty School"	"Modesto, CA"
"California Career School"	"Anaheim, CA"
"California College of the Arts"	"Oakland, CA"
"California Hair Design Academy"	"La Mesa, CA"
"California Institute of Integral Studies"	"San Francisco, CA"
"California Institute of Technology"	"Pasadena, CA"
"California Institute of the Arts"	"Valencia, CA"
"California Miramar University"	"San Diego, CA"
"California Nurses Educational Institute"	"Cathedral City, CA"
"California Polytechnic State University-San Luis Obispo"	"San Luis Obispo, CA"
"California Southern University"	"Irvine, CA"
"California State Polytechnic University-Pomona"	"Pomona, CA"
"California State University - Chico"	"Chico, CA"
"California State University - Dominguez Hills"	"Carson, CA"
"California State University - East Bay"	"Hayward, CA"
"California State University - Fullerton"	"Fullerton, CA"
"California State University - Northridge"	"Northridge, CA"
"California State University - Stanislaus"	"Turlock, CA"
"California State University Maritime Academy"	"Vallejo, CA"
"California State University Monterey Bay"	"Seaside, CA"
"California State University-Bakersfield"	"Bakersfield, CA"
"California State University-Channel Islands"	"Camarillo, CA"
"California State University-Fresno"	"Fresno, CA"
"California State University-Long Beach"	"Long Beach, CA"
"California State University-Los Angeles"	"Los Angeles, CA"
"California State University-Sacramento"	"Sacramento, CA"
"California State University-San Bernardino"	"San Bernardino, CA"
"California State University-San Marcos"	"San Marcos, CA"
"California University of Management and Sciences"	"Anaheim, CA"
"California Western School of Law"	"San Diego, CA"
"Calvin Theological Seminary"	"Grand Rapids, MI"
"Cambridge College"	"Cambridge, MA"
"Camden County College"	"Blackwood, NJ"
"Camelot College"	"Baton Rouge, LA"
"Cameo Beauty Academy"	"Oak Lawn, IL"
"Cameo College of Essential Beauty"	"Murray, UT"
"Cameron University"	"Lawton, OK"
"Campbell University"	"Buies Creek, NC"
"Canada College"	"Redwood City, CA"
"Canadian Valley Technology Center"	"El Reno, OK"
"Canisius College"	"Buffalo, NY"
"Cankdeska Cikana Community College"	"Fort Totten, ND"
"Canton City Schools Adult Community Education"	"Canton, OH"
"Cao Institute of Aesthetics"	"Alhambra, CA"
"Cape Cod Community College"	"West Barnstable, MA"
"Cape Girardeau Career and Technology Center"	"Cape Girardeau, MO"
"Capilo School of Hair Design"	"Augusta, ME"
"Capital Area School of Practical Nursing"	"Springfield, IL"
"Capital Community College"	"Hartford, CT"
"Capital University"	"Columbus, OH"
"Capitol School of Hairstyling and Esthetics"	"Omaha, NE"
"Capitol Technology University"	"Laurel, MD"
"Capri School of Hair Design"	"Nanuet, NY"
"Career Academy of Beauty"	"West Garden Grove, CA"
"Career Academy of Hair Design"	"Springdale, AR"
"Career and Technology Education Centers of Licking County"	"Newark, OH"
"Career Care Institute"	"Lancaster, CA"
"Career College of Northern Nevada"	"Sparks, NV"
"Career Quest - TX"	"San Antonio, TX"
"Career Technical Institute"	"Washington D.C., DC"
"Career Training Solutions"	"Fredericksburg, VA"
"Careers Unlimited"	"Orem, UT"
"Carl Albert State College"	"Poteau, OK"
"Carl Sandburg College"	"Galesburg, IL"
"Carleton College"	"Northfield, MN"
"Carlos Albizu University-Miami"	"Miami, FL"
"Carnegie Institute"	"Troy, MI"
"Carnegie Mellon University"	"Pittsburgh, PA"
"Carolina Academy of Cosmetic Art & Science"	"Gastonia, NC"
"Carolinas College of Health Sciences"	"Charlotte, NC"
"Carrington College California-San Leandro"	"San Leandro, CA"
"Carroll College"	"Helena, MT"
"Carroll Community College"	"Westminster, MD"
"Carteret Community College"	"Morehead City, NC"
"Carthage College"	"Kenosha, WI"
"Carthage R9 School District-Carthage Technical Center"	"Carthage, MO"
"Carver Career Center"	"Charleston, WV"
"Casa Loma College-Van Nuys"	"Van Nuys, CA"
"Casal Aveda Institute"	"Austintown, OH"
"Cascadia College"	"Bothell, WA"
"Case Western Reserve University"	"Cleveland, OH"
"Casper College"	"Casper, WY"
"Castleton University"	"Castleton, VT"
"Catawba College"	"Salisbury, NC"
"Catawba Valley Community College"	"Hickory, NC"
"Catholic Theological Union at Chicago"	"Chicago, IL"
"Cayuga Community College"	"Auburn, NY"
"Cazenovia College"	"Cazenovia, NY"
"CBD College"	"Los Angeles, CA"
"Cecil College"	"North East, MD"
"Cedar Crest College"	"Allentown, PA"
"Cedarville University"	"Cedarville, OH"
"Celebrity School of Beauty"	"Miami, FL"
"Centenary College of Louisiana"	"Shreveport, LA"
"Center for Arts and Technology-Brandywine Campus"	"Coatesville, PA"
"Central Arizona College"	"Coolidge, AZ"
"Central Baptist College"	"Conway, AR"
"Central Carolina Community College"	"Sanford, NC"
"Central Christian College of the Bible"	"Moberly, MO"
"Central College"	"Pella, IA"
"Central Community College"	"Grand Island, NE"
"Central Connecticut State University"	"New Britain, CT"
"Central Lakes College"	"Brainerd, MN"
"Central Maine Community College"	"Auburn, ME"
"Central Methodist University"	"Fayette, MO"
"Central Michigan University"	"Mount Pleasant, MI"
"Central New Mexico Community College"	"Albuquerque, NM"
"Central Ohio Technical College"	"Newark, OH"
"Central Oklahoma College"	"Oklahoma City, OK"
"Central Pennsylvania Institute of Science and Technology"	"Pleasant Gap, PA"
"Central Piedmont Community College"	"Charlotte, NC"
"Central School of Practical Nursing - OH"	"Cleveland, OH"
"Central State University"	"Wilberforce, OH"
"Central Technology Center"	"Drumright, OK"
"Central Texas College"	"Killeen, TX"
"Central Virginia Community College"	"Lynchburg, VA"
"Central Washington University"	"Ellensburg, WA"
"Central Wyoming College"	"Riverton, WY"
"Centralia College"	"Centralia, WA"
"Centre College"	"Danville, KY"
"Centura College-Chesapeake"	"Chesapeake, VA"
"Centura College-Virginia Beach"	"Virginia Beach, VA"
"Century College"	"White Bear Lake, MN"
"Cerritos College"	"Norwalk, CA"
"CES College"	"Burbank, CA"
"CET-Alexandria"	"Alexandria, VA"
"CET-Coachella"	"Coachella, CA"
"CET-El Centro"	"El Centro, CA"
"CET-El Paso"	"El Paso, TX"
"CET-Oxnard"	"Oxnard, CA"
"CET-San Bernardino"	"San Bernardino, CA"
"CET-San Diego"	"San Diego, CA"
"CET-Santa Maria"	"Santa Maria, CA"
"CET-Sobrato"	"San Jose, CA"
"CET-Watsonville"	"Watsonville, CA"
"Chabot College"	"Hayward, CA"
"Chadron State College"	"Chadron, NE"
"Chaffey College"	"Rancho Cucamonga, CA"
"Chamberlain College of Nursing-Georgia"	"Atlanta, GA"
"Chamberlain College of Nursing-Indiana"	"Indianapolis, IN"
"Chamberlain College of Nursing-Missouri"	"St. Louis, MO"
"Chamberlain College of Nursing-Texas"	"Houston, TX"
"Chamberlain College of Nursing-Virginia"	"Arlington, VA"
"Chaminade University of Honolulu"	"Honolulu, HI"
"Chapman University"	"Orange, CA"
"Charles A. Jones Career and Education Center"	"Sacramento, CA"
"Charles R Drew University of Medicine and Science"	"Los Angeles, CA"
"Charleston Cosmetology Institute"	"Charleston, SC"
"Charleston School of Beauty Culture"	"Charleston, WV"
"Charleston School of Law"	"Charleston, SC"
"Charleston Southern University"	"Charleston, SC"
"Charlotte Christian College"	"Charlotte, NC"
"Charlotte Technical Center"	"Port Charlotte, FL"
"Charter Oak State College"	"New Britain, CT"
"Chatham University"	"Pittsburgh, PA"
"Chattahoochee Valley Community College"	"Phenix City, AL"
"Chattanooga State Community College"	"Chattanooga, TN"
"Chesapeake College"	"Wye Mills, MD"
"Chestnut Hill College"	"Philadelphia, PA"
"Cheyney University of Pennsylvania"	"Cheyney, PA"
"Chicago State University"	"Chicago, IL"
"Chicago Theological Seminary"	"Chicago, IL"
"Chief Dull Knife College"	"Lame Deer, MT"
"Chipola College"	"Marianna, FL"
"Chisholm Trail Technology Center"	"Omega, OK"
"Choffin Career  and Technical Center"	"Youngstown, OH"
"CHOICE High School and Technical Center"	"Fort Walton Beach, FL"
"Chowan University"	"Murfreesboro, NC"
"The Christ College of Nursing and Health Sciences"	"Cincinnati, OH"
"Christian Brothers University"	"Memphis, TN"
"Christian Theological Seminary"	"Indianapolis, IN"
"Christine Valmy International School of Esthetics & Cosmetology"	"Pine Brook, NJ"
"Christopher Newport University"	"Newport News, VA"
"Cincinnati Academy A Paul Mitchell Partner School"	"Cincinnati, OH"
"Cincinnati Christian University"	"Cincinnati, OH"
"Cinta Aveda Institute"	"San Francisco, CA"
"Cisco College"	"Cisco, TX"
"Citadel Military College of South Carolina"	"Charleston, SC"
"Citizens School of Nursing"	"New Kensington, PA"
"Citrus College"	"Glendora, CA"
"City College of San Francisco"	"San Francisco, CA"
"City Colleges of Chicago-Harold Washington College"	"Chicago, IL"
"City Colleges of Chicago-Harry S Truman College"	"Chicago, IL"
"City Colleges of Chicago-Kennedy-King College"	"Chicago, IL"
"City Colleges of Chicago-Malcolm X College"	"Chicago, IL"
"City Colleges of Chicago-Olive-Harvey College"	"Chicago, IL"
"City Colleges of Chicago-Richard J Daley College"	"Chicago, IL"
"City Colleges of Chicago-Wilbur Wright College"	"Chicago, IL"
"City Pointe Beauty Academy"	"Webb City, MO"
"City University of Seattle"	"Seattle, WA"
"City Vision University"	"Kansas City, MO"
"Clackamas Community College"	"Oregon City, OR"
"Claflin University"	"Orangeburg, SC"
"Claremont McKenna College"	"Claremont, CA"
"Claremont School of Theology"	"Claremont, CA"
"Clarendon College"	"Clarendon, TX"
"Clarion University"	"Clarion, PA"
"Clark Atlanta University"	"Atlanta, GA"
"Clark College"	"Vancouver, WA"
"Clark State Community College"	"Springfield, OH"
"Clark University"	"Worcester, MA"
"Clarke University"	"Dubuque, IA"
"Clarks Summit University"	"Clarks Summit, PA"
"Clarkson College"	"Omaha, NE"
"Clarkson University"	"Potsdam, NY"
"Clary Sage College"	"Tulsa, OK"
"Clatsop Community College"	"Astoria, OR"
"Clayton State University"	"Morrow, GA"
"Cleary University"	"Ann Arbor, MI"
"Clemson University"	"Clemson, SC"
"Cleveland Community College"	"Shelby, NC"
"Cleveland Institute of Art"	"Cleveland, OH"
"Cleveland State Community College"	"Cleveland, TN"
"Cleveland State University"	"Cleveland, OH"
"Cleveland University-Kansas City"	"Overland Park, KS"
"Clinton College"	"Rock Hill, SC"
"Clinton Community College"	"Plattsburgh, NY"
"Cloud County Community College"	"Concordia, KS"
"Clovis Adult Education"	"Clovis, CA"
"Clovis Community College - NM"	"Clovis, NM"
"CNI College"	"Orange, CA"
"Coahoma Community College"	"Clarksdale, MS"
"Coastal Bend College"	"Beeville, TX"
"Coastal Carolina Community College"	"Jacksonville, NC"
"Coastal Carolina University"	"Conway, SC"
"Coastal Pines Technical College"	"Waycross, GA"
"Coastline Beauty College"	"Fountain Valley, CA"
"Coe College"	"Cedar Rapids, IA"
"Coffeyville Community College"	"Coffeyville, KS"
"Cogswell College"	"Sunnyvale, CA"
"Coker College"	"Hartsville, SC"
"Colby College"	"Waterville, ME"
"Colby Community College"	"Colby, KS"
"Colby-Sawyer College"	"New London, NH"
"Colgate University"	"Hamilton, NY"
"Colleen O'Haras Beauty Academy"	"Santa Ana, CA"
"College of Alameda"	"Alameda, CA"
"College of Biblical Studies-Houston"	"Houston, TX"
"College of Business and Technology-Hialeah"	"Hialeah, FL"
"College of Charleston"	"Charleston, SC"
"College of Coastal Georgia"	"Brunswick, GA"
"College of Hair Design - NE"	"Lincoln, NE"
"The College of Idaho"	"Caldwell, ID"
"College of Marin"	"Kentfield, CA"
"College of Menominee Nation"	"Keshena, WI"
"College of Mount Saint Vincent"	"Bronx, NY"
"The College of New Jersey"	"Ewing, NJ"
"College of Our Lady of the Elms"	"Chicopee, MA"
"College of Saint Benedict"	"Saint Joseph, MN"
"College of Saint Elizabeth"	"Morristown, NJ"
"College of Saint Mary"	"Omaha, NE"
"The College of Saint Rose"	"Albany, NY"
"College of San Mateo"	"San Mateo, CA"
"College of Southern Idaho"	"Twin Falls, ID"
"College of Southern Nevada"	"Las Vegas, NV"
"College of the Albemarle"	"Elizabeth City, NC"
"College of the Canyons"	"Santa Clarita, CA"
"College of the Desert"	"Palm Desert, CA"
"College of the Holy Cross"	"Worcester, MA"
"College of the Mainland"	"Texas City, TX"
"College of the Muscogee Nation"	"Okmulgee, OK"
"College of the Ozarks"	"Point Lookout, MO"
"College of the Redwoods"	"Eureka, CA"
"College of the Siskiyous"	"Weed, CA"
"The College of Westchester"	"White Plains, NY"
"College of Western Idaho"	"Nampa, ID"
"College of William and Mary"	"Williamsburg, VA"
"The College of Wooster"	"Wooster, OH"
"Collin College"	"McKinney, TX"
"Collins College"	"Phoenix, AZ"
"Colorado College"	"Colorado Springs, CO"
"Colorado Mesa University"	"Grand Junction, CO"
"Colorado Northwestern Community College"	"Rangely, CO"
"Colorado School of Mines"	"Golden, CO"
"Colorado School of Trades"	"Lakewood, CO"
"Colorado School of Traditional Chinese Medicine"	"Denver, CO"
"Colorado State University - Fort Collins"	"Fort Collins, CO"
"Columbia Basin College"	"Pasco, WA"
"Columbia College"	"Columbia, MO"
"Columbia College - CA"	"Sonora, CA"
"Columbia College - SC"	"Columbia, SC"
"Columbia College Chicago"	"Chicago, IL"
"Columbia College of Nursing"	"Glendale, WI"
"Columbia Gorge Community College"	"The Dalles, OR"
"Columbia Institute"	"Silver Spring, MD"
"Columbia State Community College"	"Columbia, TN"
"Columbia Theological Seminary"	"Decatur, GA"
"Columbia-Greene Community College"	"Hudson, NY"
"Columbiana County Career and Technical Center"	"Lisbon, OH"
"Columbus College of Art and Design"	"Columbus, OH"
"Columbus State Community College"	"Columbus, OH"
"Columbus State University"	"Columbus, GA"
"Columbus Technical College"	"Columbus, GA"
"Commonwealth Technical Institute"	"Johnstown, PA"
"Community Care College"	"Tulsa, OK"
"Community College of Aurora"	"Aurora, CO"
"The Community College of Baltimore County"	"Baltimore, MD"
"Community College of Denver"	"Denver, CO"
"Community College of Philadelphia"	"Philadelphia, PA"
"Community College of Rhode Island"	"Warwick, RI"
"Community College of Vermont"	"Winooski, VT"
"Community Services Division-Alliance City"	"Alliance, OH"
"Compton College"	"Compton, CA"
"Compu-Med Vocational Careers Corp"	"Hialeah, FL"
"Computer Tutor Business and Technical Institute"	"Modesto, CA"
"Concord University"	"Athens, WV"
"Concordia College at Moorhead"	"Moorhead, MN"
"Concordia University - Saint Paul"	"Saint Paul, MN"
"Concordia University - Texas"	"Austin, TX"
"Conemaugh Valley Memorial Hospital"	"Johnstown, PA"
"Connecticut College"	"New London, CT"
"Connors State College"	"Warner, OK"
"Conservatory of Recording Arts and Sciences"	"Tempe, AZ"
"Continental School of Beauty Culture"	"Mattydale, NY"
"Contra Costa College"	"San Pablo, CA"
"Converse College"	"Spartanburg, SC"
"Cooper Union for the Advancement of Science and Art"	"New York, NY"
"Copiah-Lincoln Community College"	"Wesson, MS"
"Copper Mountain Community College"	"Joshua Tree, CA"
"Coppin State University"	"Baltimore, MD"
"Corban University"	"Salem, OR"
"Corinth Academy of Cosmetology"	"Corinth, MS"
"Cornell College"	"Mount Vernon, IA"
"Cornell University"	"Ithaca, NY"
"Cornerstone University"	"Grand Rapids, MI"
"Cornish College of the Arts"	"Seattle, WA"
"Cosmetology Academy of Texarkana"	"Texarkana, TX"
"Cosmetology Career Center LLC"	"Carrollton, TX"
"Cosmetology Training Center"	"Lafayette, LA"
"Cossatot Community College of the University of Arkansas"	"De Queen, AR"
"Cosumnes River College"	"Sacramento, CA"
"Cottey College"	"Nevada, MO"
"County College of Morris"	"Randolph, NJ"
"Court Reporting Institute of St Louis"	"Clayton, MO"
"Covenant College"	"Lookout Mountain, GA"
"Covenant School of Nursing and Allied Health"	"Lubbock, TX"
"Covenant Theological Seminary"	"St. Louis, MO"
"Cowley County Community College"	"Arkansas City, KS"
"Cox College"	"Springfield, MO"
"Coyne College"	"Chicago, IL"
"Crafton Hills College"	"Yucaipa, CA"
"Cranbrook Academy of Art"	"Bloomfield Hills, MI"
"Craven Community College"	"New Bern, NC"
"The Creative Center"	"Omaha, NE"
"The Creative Circus"	"Atlanta, GA"
"Creative Hair Styling Academy Inc"	"Highland, IN"
"Creative Images Institute of Cosmetology-North Dayton"	"Dayton, OH"
"Crescent City Bartending School"	"New Orleans, LA"
"Crevier's School of Cosmetology"	"Kalispell, MT"
"Criswell College"	"Dallas, TX"
"Crowley's Ridge College"	"Paragould, AR"
"Crown College"	"Saint Bonifacius, MN"
"Culinary Institute of America"	"Hyde Park, NY"
"Culver-Stockton College"	"Canton, MO"
"Cumberland County College"	"Vineland, NJ"
"Cumberland University"	"Lebanon, TN"
"CUNY Bernard M Baruch College"	"New York, NY"
"CUNY Borough of Manhattan Community College"	"New York, NY"
"CUNY Bronx Community College"	"Bronx, NY"
"CUNY Brooklyn College"	"Brooklyn, NY"
"CUNY City College"	"New York, NY"
"CUNY College of Staten Island"	"Staten Island, NY"
"CUNY Graduate School and University Center"	"New York, NY"
"CUNY Guttman Community College"	"New York, NY"
"CUNY Hostos Community College"	"Bronx, NY"
"CUNY Hunter College"	"New York, NY"
"CUNY John Jay College of Criminal Justice"	"New York, NY"
"CUNY Kingsborough Community College"	"Brooklyn, NY"
"CUNY LaGuardia Community College"	"Long Island City, NY"
"CUNY Lehman College"	"Bronx, NY"
"CUNY Medgar Evers College"	"Brooklyn, NY"
"CUNY New York City College of Technology"	"Brooklyn, NY"
"CUNY Queens College"	"Flushing, NY"
"CUNY Queensborough Community College"	"Bayside, NY"
"CUNY School of Law at Queens College"	"Flushing, NY"
"CUNY York College"	"Jamaica, NY"
"Curry College"	"Milton, MA"
"Cuyahoga Valley Career Center"	"Brecksville, OH"
"Cuyamaca College"	"El Cajon, CA"
"CyberTex Institute of Technology"	"Austin, TX"
"Cypress College"	"Cypress, CA"
"D'Youville College"	"Buffalo, NY"
"Dabney S Lancaster Community College"	"Clifton Forge, VA"
"Daemen College"	"Amherst, NY"
"Dakota College at Bottineau"	"Bottineau, ND"
"Dakota County Technical College"	"Rosemount, MN"
"Dakota State University"	"Madison, SD"
"Dakota Wesleyan University"	"Mitchell, SD"
"Dallas Baptist University"	"Dallas, TX"
"Dallas Barber & Stylist College"	"Dallas, TX"
"Dallas Christian College"	"Dallas, TX"
"Dallas College Brookhaven Campus"	"Farmers Branch, TX"
"Dallas College Cedar Valley Campus"	"Lancaster, TX"
"Dallas Nursing Institute"	"Dallas, TX"
"Dallas Theological Seminary"	"Dallas, TX"
"Dalton State College"	"Dalton, GA"
"Danville Area Community College"	"Danville, IL"
"Danville Community College"	"Danville, VA"
"Dartmouth College"	"Hanover, NH"
"David Pressley School of Cosmetology"	"Royal Oak, MI"
"Davidson College"	"Davidson, NC"
"Davis & Elkins College"	"Elkins, WV"
"Davis College - OH"	"Toledo, OH"
"Davis Technical College"	"Kaysville, UT"
"Dawn Career Institute"	"Wilmington, DE"
"Dawson Community College"	"Glendive, MT"
"Daytona College"	"Ormond Beach, FL"
"De Anza College"	"Cupertino, CA"
"Dean College"	"Franklin, MA"
"Defiance College"	"Defiance, OH"
"Del Mar College"	"Corpus Christi, TX"
"Delaware College of Art and Design"	"Wilmington, DE"
"Delaware State University"	"Dover, DE"
"Delaware Valley University"	"Doylestown, PA"
"Delgado Community College"	"New Orleans, LA"
"Delta College"	"University Center, MI"
"Delta Montrose Technical College"	"Delta, CO"
"Delta State University"	"Cleveland, MS"
"Delta Technical College"	"Horn Lake, MS"
"Denison University"	"Granville, OH"
"Denmark Technical College"	"Denmark, SC"
"Denver College of Nursing"	"Denver, CO"
"Denver Seminary"	"Littleton, CO"
"DePaul University"	"Chicago, IL"
"DePauw University"	"Greencastle, IN"
"Des Moines University"	"Des Moines, IA"
"DeSales University"	"Center Valley, PA"
"Design Institute of San Diego"	"San Diego, CA"
"DeVry College of New York"	"New York, NY"
"Diablo Valley College"	"Pleasant Hill, CA"
"Diamond Beauty College"	"South El Monte, CA"
"Dickinson College"	"Carlisle, PA"
"Dickinson State University"	"Dickinson, ND"
"DigiPen Institute of Technology"	"Redmond, WA"
"Dillard University"	"New Orleans, LA"
"Dine College"	"Tsaile, AZ"
"Diversified Vocational College"	"Los Angeles, CA"
"Dixie Technical College"	"St. George, UT"
"Doane College-Crete"	"Crete, NE"
"Doane University"	"Lincoln, NE"
"Dodge City Community College"	"Dodge City, KS"
"Dominican College of Blauvelt"	"Orangeburg, NY"
"Dominican University"	"River Forest, IL"
"Dominican University of California"	"San Rafael, CA"
"Dongguk University Los Angeles"	"Los Angeles, CA"
"Donnelly College"	"Kansas City, KS"
"Dordt University"	"Sioux Center, IA"
"Dorothea Hopfer School of Nursing-Mt Vernon Hospital"	"Mount Vernon, NY"
"Douglas Education Center"	"Monessen, PA"
"Douglas J Aveda Institute"	"East Lansing, MI"
"Downey Adult School"	"Downey, CA"
"Drake University"	"Des Moines, IA"
"Drew University"	"Madison, NJ"
"Drexel University"	"Philadelphia, PA"
"Drury University"	"Springfield, MO"
"Duke University"	"Durham, NC"
"Dunwoody College of Technology"	"Minneapolis, MN"
"Duquesne University"	"Pittsburgh, PA"
"Dutchess BOCES-School of Practical Nursing"	"Poughkeepsie, NY"
"Dutchess Community College"	"Poughkeepsie, NY"
"DuVall's School of Cosmetology"	"Bedford, TX"
"Dyersburg State Community College"	"Dyersburg, TN"
"Eagle Rock College"	"Los Angeles, CA"
"Earlham College"	"Richmond, IN"
"East Arkansas Community College"	"Forrest City, AR"
"East Carolina University"	"Greenville, NC"
"East Central College"	"Union, MO"
"East Central Community College"	"Decatur, MS"
"East Central University"	"Ada, OK"
"East Georgia State College"	"Swainsboro, GA"
"East Los Angeles College"	"Monterey Park, CA"
"East Mississippi Community College"	"Scooba, MS"
"East San Gabriel Valley Regional Occupational Program"	"West Covina, CA"
"East Stroudsburg University of Pennsylvania"	"East Stroudsburg, PA"
"East Tennessee State University"	"Johnson City, TN"
"East Texas Baptist University"	"Marshall, TX"
"East Valley Institute of Technology"	"Mesa, AZ"
"East West College of Natural Medicine"	"Sarasota, FL"
"Eastern Arizona College"	"Thatcher, AZ"
"Eastern Center for Arts and Technology"	"Willow Grove, PA"
"Eastern Connecticut State University"	"Willimantic, CT"
"Eastern Florida State College"	"Cocoa, FL"
"Eastern Gateway Community College"	"Steubenville, OH"
"Eastern Idaho Technical College"	"Idaho Falls, ID"
"Eastern Illinois University"	"Charleston, IL"
"Eastern Iowa Community College District"	"Davenport, IA"
"Eastern Maine Community College"	"Bangor, ME"
"Eastern Mennonite University"	"Harrisonburg, VA"
"Eastern Nazarene College"	"Quincy, MA"
"Eastern New Mexico University - Main Campus"	"Portales, NM"
"Eastern New Mexico University-Roswell Campus"	"Roswell, NM"
"Eastern New Mexico University-Ruidoso Campus"	"Ruidoso, NM"
"Eastern Oklahoma County Technology Center"	"Choctaw, OK"
"Eastern Oklahoma State College"	"Wilburton, OK"
"Eastern Shore Community College"	"Melfa, VA"
"Eastern Suffolk BOCES-School of Practical Nursing"	"Patchogue, NY"
"Eastern University"	"Saint Davids, PA"
"Eastern Virginia Medical School"	"Norfolk, VA"
"Eastern West Virginia Community and Technical College"	"Moorefield, WV"
"Eastern Wyoming College"	"Torrington, WY"
"Eastfield College"	"Mesquite, TX"
"Eastland-Fairfield Career and Technical Schools"	"Groveport, OH"
"Ecclesia College"	"Springdale, AR"
"Eckerd College"	"St. Petersburg, FL"
"Eden Theological Seminary"	"Webster Grove, MO"
"Edgecombe Community College"	"Tarboro, NC"
"Edinboro University of Pennsylvania"	"Edinboro, PA"
"Edison State Community College"	"Piqua, OH"
"Edmonds College"	"Lynnwood, WA"
"EDP School of Computer Programming"	"Brooklyn, NY"
"Edward Via College of Osteopathic Medicine"	"Blacksburg, VA"
"Edward Waters College"	"Jacksonville, FL"
"Ehove Career Center"	"Milan, OH"
"El Camino Community College District"	"Torrance, CA"
"El Centro College"	"Dallas, TX"
"El Paso Community College"	"El Paso, TX"
"Elaine Steven Beauty College"	"St. Louis, MO"
"Elgin Community College"	"Elgin, IL"
"Elizabeth City State University"	"Elizabeth City, NC"
"Elizabethtown College"	"Elizabethtown, PA"
"Elizabethtown Community and Technical College"	"Elizabethtown, KY"
"Ellsworth Community College"	"Iowa Falls, IA"
"Elmhurst College"	"Elmhurst, IL"
"Elmira College"	"Elmira, NY"
"Elon University"	"Elon, NC"
"Embry Riddle Aeronautical University-Prescott"	"Prescott, AZ"
"Embry-Riddle Aeronautical University - Worldwide"	"Daytona Beach, FL"
"Embry-Riddle Aeronautical University-Daytona Beach"	"Daytona Beach, FL"
"Emerson College"	"Boston, MA"
"Emily Griffith Technical College"	"Denver, CO"
"Emmanuel College - GA"	"Franklin Springs, GA"
"Emmanuel College - MA"	"Boston, MA"
"Emmaus Bible College"	"Dubuque, IA"
"Emory and Henry College"	"Emory, VA"
"Emory University"	"Atlanta, GA"
"Emperor's College of Traditional Oriental Medicine"	"Santa Monica, CA"
"Empire Beauty School-Augusta"	"Augusta, GA"
"Empire Beauty School-Rochester"	"Rochester, NY"
"Empire Beauty School-Stone Park"	"Stone Park, IL"
"Empire Beauty School-Vernon Hills"	"Vernon Hills, IL"
"Empire College"	"Santa Rosa, CA"
"Employment Solutions-College for Technical Education"	"Lexington, KY"
"Endicott College"	"Beverly, MA"
"Environmental Technical Institute"	"Itasca, IL"
"Episcopal Theological Seminary of the Southwest"	"Austin, TX"
"Eric Fisher Academy"	"Wichita, KS"
"Erie 1 BOCES"	"West Seneca, NY"
"Erie 2 Chautauqua Cattaraugus BOCES-Practical Nursing Program"	"Angola, NY"
"Erie Community College"	"Buffalo, NY"
"Erie Institute of Technology Inc"	"Erie, PA"
"Erikson Institute"	"Chicago, IL"
"Erskine College and Seminary"	"Due West, SC"
"Erwin Technical College"	"Tampa, FL"
"Essex County College"	"Newark, NJ"
"Estes Institute of Cosmetology Arts and Science"	"Visalia, CA"
"Esthetiques Cosmetology Institute"	"Temecula, CA"
"ETI Technical College"	"Niles, OH"
"Eureka College"	"Eureka, IL"
"Evangel University"	"Springfield, MO"
"Everett Community College"	"Everett, WA"
"The Evergreen State College"	"Olympia, WA"
"Evergreen Valley College"	"San Jose, CA"
"Excelsior University"	"Albany, NY"
"Extreme Institute by Nelly"	"St. Louis, MO"
"Fairfield University"	"Fairfield, CT"
"Fairleigh Dickinson University-College at Florham"	"Madison, NJ"
"Fairmont State University"	"Fairmont, WV"
"Faith Baptist Bible College and Theological Seminary"	"Ankeny, IA"
"Faith International University"	"Tacoma, WA"
"Farmingdale State College"	"Farmingdale, NY"
"Fashion Institute of Technology"	"New York, NY"
"Fayette County Area Vocational-Technical School-Practical Nursing Program"	"Uniontown, PA"
"Fayetteville State University"	"Fayetteville, NC"
"Feather River Community College District"	"Quincy, CA"
"Felician University"	"Lodi, NJ"
"Ferris State University"	"Big Rapids, MI"
"Ferrum College"	"Ferrum, VA"
"Fielding Graduate University"	"Santa Barbara, CA"
"Finger Lakes Community College"	"Canandaigua, NY"
"Finger Lakes Health College of Nursing"	"Geneva, NY"
"Finlandia University"	"Hancock, MI"
"First Coast Technical College"	"St. Augustine, FL"
"Fisher College"	"Boston, MA"
"Fisk University"	"Nashville, TN"
"Five Branches University"	"Santa Cruz, CA"
"Five Towns College"	"Dix Hills, NY"
"Flagler College-St Augustine"	"St. Augustine, FL"
"Flagler College-Tallahassee"	"Tallahassee, FL"
"Flagler Technical College"	"Palm Coast, FL"
"Flathead Valley Community College"	"Kalispell, MT"
"Fletcher Technical Community College"	"Houma, LA"
"Flint Hills Technical College"	"Emporia, KS"
"Florence-Darlington Technical College"	"Florence, SC"
"Florida Academy"	"Fort Myers, FL"
"Florida Atlantic University"	"Boca Raton, FL"
"Florida Barber Academy"	"Pompano Beach, FL"
"Florida Coastal School of Law"	"Jacksonville, FL"
"Florida College"	"Temple Terrace, FL"
"Florida College of Integrative Medicine"	"Orlando, FL"
"Florida Education Institute"	"Miami, FL"
"Florida Gateway College"	"Lake City, FL"
"Florida Institute of Recording, Sound and Technology"	"Orlando, FL"
"Florida Institute of Technology"	"Melbourne, FL"
"Florida International University"	"Miami, FL"
"Florida Keys Community College"	"Key West, FL"
"Florida Memorial University"	"Miami Gardens, FL"
"Florida Southern College"	"Lakeland, FL"
"Florida State College at Jacksonville"	"Jacksonville, FL"
"Folsom Lake College"	"Folsom, CA"
"Fond du Lac Tribal and Community College"	"Cloquet, MN"
"Foothill College"	"Los Altos Hills, CA"
"Forrest College"	"Anderson, SC"
"Forsyth Technical Community College"	"Winston Salem, NC"
"Fort Hays State University"	"Hays, KS"
"Fort Lewis College"	"Durango, CO"
"Fort Peck Community College"	"Poplar, MT"
"Fort Scott Community College"	"Fort Scott, KS"
"Fort Worth Beauty School"	"Fort Worth, TX"
"Fountainhead College of Technology"	"Knoxville, TN"
"Four County Career Center"	"Archbold, OH"
"Fox College"	"Bedford Park, IL"
"Framingham State University"	"Framingham, MA"
"Francis Marion University"	"Florence, SC"
"Francis Tuttle Technology Center"	"Oklahoma City, OK"
"Franciscan University of Steubenville"	"Steubenville, OH"
"Frank Phillips College"	"Borger, TX"
"Franklin Academy"	"Cleveland, TN"
"Franklin and Marshall College"	"Lancaster, PA"
"Franklin College"	"Franklin, IN"
"Franklin Pierce University"	"Rindge, NH"
"Franklin Technology-MSSU"	"Joplin, MO"
"Franklin University"	"Columbus, OH"
"Franklin W. Olin College of Engineering"	"Needham, MA"
"Fred W Eberle Technical Center"	"Buckhannon, WV"
"Frederick Community College"	"Frederick, MD"
"Freed-Hardeman University"	"Henderson, TN"
"French Culinary Institute"	"New York, NY"
"Fresno City College"	"Fresno, CA"
"Friends University"	"Wichita, KS"
"Front Range Community College"	"Westminster, CO"
"Frontier Community College"	"Fairfield, IL"
"Frontier Nursing University"	"Hyden, KY"
"Frostburg State University"	"Frostburg, MD"
"Fullerton College"	"Fullerton, CA"
"Fulton-Montgomery Community College"	"Johnstown, NY"
"Furman University"	"Greenville, SC"
"Futura Career Institute"	"Hialeah, FL"
"Future Generations University"	"Franklin, WV"
"Gadsden State Community College"	"Gadsden, AL"
"Gallaudet University"	"Washington D.C., DC"
"Gallery College of Beauty"	"Clinton Township, MI"
"Gallia Jackson Vinton Joint Vocational School District"	"Rio Grande, OH"
"Galveston College"	"Galveston, TX"
"Gannon University"	"Erie, PA"
"Garden City Community College"	"Garden City, KS"
"Gardner Webb University"	"Boiling Springs, NC"
"Garnet Career Center"	"Charleston, WV"
"Garrett College"	"McHenry, MD"
"Garrett-Evangelical Theological Seminary"	"Evanston, IL"
"Gary Manuel Aveda Institute"	"Seattle, WA"
"Gaston College"	"Dallas, NC"
"Gateway Community and Technical College"	"Florence, KY"
"GateWay Community College - AZ"	"Phoenix, AZ"
"Gateway Community College - CT"	"New Haven, CT"
"Gateway Technical College"	"Kenosha, WI"
"Gavilan College"	"Gilroy, CA"
"Geisinger Commonwealth School of Medicine"	"Scranton, PA"
"Gemini School of Visual Arts & Communication"	"Cedar Park, TX"
"Gemological Institute of America"	"Carlsbad, CA"
"Gemological Institute of America-New York"	"New York, NY"
"Genesee Community College"	"Batavia, NY"
"Genesee Valley BOCES-Practical Nursing Program"	"Batavia, NY"
"George Fox University"	"Newberg, OR"
"George Stone Technical College"	"Pensacola, FL"
"George T Baker Aviation Technical College"	"Miami, FL"
"George Washington University - Engineering"	"Washington D.C., DC"
"Georgetown College"	"Georgetown, KY"
"Georgetown University"	"Washington D.C., DC"
"Georgia Career Institute"	"Conyers, GA"
"Georgia Central University"	"Lilburn, GA"
"Georgia College & State University"	"Milledgeville, GA"
"Georgia Gwinnett College"	"Lawrenceville, GA"
"Georgia Highlands College"	"Rome, GA"
"Georgia Institute of Cosmetology"	"Athens, GA"
"Georgia Military College"	"Milledgeville, GA"
"Georgia Piedmont Technical College"	"Clarkston, GA"
"Georgia Southern University"	"Statesboro, GA"
"Georgia Southwestern State University"	"Americus, GA"
"Georgia State University"	"Atlanta, GA"
"Georgia State University-Perimeter College"	"Decatur, GA"
"Georgian Court University"	"Lakewood, NJ"
"Germanna Community College"	"Locust Grove, VA"
"Gettysburg College"	"Gettysburg, PA"
"Glen Dow Academy of Hair Design"	"Spokane, WA"
"Glen Oaks Community College"	"Centreville, MI"
"Glendale Community College - AZ"	"Glendale, AZ"
"Glendale Community College - CA"	"Glendale, CA"
"Glenville State College"	"Glenville, WV"
"Gnomon School of Visual Effects"	"Hollywood, CA"
"God's Bible School and College"	"Cincinnati, OH"
"Goddard College"	"Plainfield, VT"
"Gogebic Community College"	"Ironwood, MI"
"Golden West College"	"Huntington Beach, CA"
"Goldey-Beacom College"	"Wilmington, DE"
"Gonzaga University"	"Spokane, WA"
"Good Samaritan College of Nursing & Health Science"	"Cincinnati, OH"
"Goodwin University"	"East Hartford, CT"
"Gordon Cooper Technology Center"	"Shawnee, OK"
"Gordon State College - GA"	"Barnesville, GA"
"Gordon-Conwell Theological Seminary"	"South Hamilton, MA"
"Goshen College"	"Goshen, IN"
"Goucher College"	"Baltimore, MD"
"Governors State University"	"University Park, IL"
"Grabber School of Hair Design"	"Ballwin, MO"
"Grace Christian University"	"Wyoming, MI"
"Grace College and Theological Seminary"	"Winona Lake, IN"
"Grace College of Divinity"	"Fayetteville, NC"
"Grace School of Theology"	"Conroe, TX"
"Grambling State University"	"Grambling, LA"
"Grand View University"	"Des Moines, IA"
"Granite State College"	"Concord, NH"
"Gratz College"	"Melrose Park, PA"
"Grays Harbor College"	"Aberdeen, WA"
"Grayson College"	"Denison, TX"
"Great Basin College"	"Elko, NV"
"Great Bay Community College"	"Portsmouth, NH"
"Great Lakes Christian College"	"Lansing, MI"
"Great Lakes Institute of Technology"	"Erie, PA"
"Great Oaks Career Campuses"	"Cincinnati, OH"
"Great Plains Technology Center"	"Lawton, OK"
"Greater Altoona Career & Technology Center"	"Altoona, PA"
"Greater Johnstown Career and Technology Center"	"Johnstown, PA"
"Green Country Technology Center"	"Okmulgee, OK"
"Green River Community College"	"Auburn, WA"
"Greene County Career Center"	"Xenia, OH"
"Greenfield Community College"	"Greenfield, MA"
"Greensboro College"	"Greensboro, NC"
"Greenville Technical College"	"Greenville, SC"
"Grinnell College"	"Grinnell, IA"
"Grossmont College"	"El Cajon, CA"
"Grove City College"	"Grove City, PA"
"Guilford College"	"Greensboro, NC"
"Guilford Technical Community College"	"Jamestown, NC"
"Gulf Coast State College"	"Panama City, FL"
"Gustavus Adolphus College"	"Saint Peter, MN"
"H Councill Trenholm State Community College"	"Montgomery, AL"
"Hacienda La Puente Adult Education"	"La Puente, CA"
"Hagerstown Community College"	"Hagerstown, MD"
"Hair Academy Inc-New Carrollton"	"New Carrollton, MD"
"Hair Academy Paul Mitchell Partner School"	"Rexburg, ID"
"Hairmasters Institute of Cosmetology"	"Bloomington, IL"
"Halifax Community College"	"Weldon, NC"
"Hamilton College - NY"	"Clinton, NY"
"Hamline University"	"Saint Paul, MN"
"Hampden-Sydney College"	"Hampden-Sydney, VA"
"Hampshire College"	"Amherst, MA"
"Hampton University"	"Hampton, VA"
"Hannibal-LaGrange University"	"Hannibal, MO"
"Hanover College"	"Hanover, IN"
"Harcum College"	"Bryn Mawr, PA"
"Hardin-Simmons University"	"Abilene, TX"
"Harding University"	"Searcy, AR"
"Harford Community College"	"Bel Air, MD"
"Harrington College of Design"	"Chicago, IL"
"Harris-Stowe State University"	"St. Louis, MO"
"Harrisburg Area Community College-Harrisburg"	"Harrisburg, PA"
"Harrisburg University of Science and Technology"	"Harrisburg, PA"
"Hartford Seminary"	"Hartford, CT"
"Hartnell College"	"Salinas, CA"
"Hartwick College"	"Oneonta, NY"
"Harvard University"	"Cambridge, MA"
"Harvey Mudd College"	"Claremont, CA"
"Haskell Indian Nations University"	"Lawrence, KS"
"Hastings College"	"Hastings, NE"
"Haverford College"	"Haverford, PA"
"Hawai'i Pacific University"	"Honolulu, HI"
"Hawaii Community College"	"Hilo, HI"
"Hawaii Medical College"	"Honolulu, HI"
"Hawkeye Community College"	"Waterloo, IA"
"Haywood Community College"	"Clyde, NC"
"Hazard Community and Technical College"	"Hazard, KY"
"Heartland Community College"	"Normal, IL"
"Hebrew College"	"Newton Centre, MA"
"Hebrew Theological College"	"Skokie, IL"
"Hebrew Union College-Jewish Institute of Religion-New York"	"New York, NY"
"Heidelberg University"	"Tiffin, OH"
"Helena College University of Montana"	"Helena, MT"
"Helene Fuld College of Nursing"	"New York, NY"
"Hellenic College-Holy Cross Greek Orthodox School of Theology"	"Brookline, MA"
"Helms College"	"Macon, GA"
"Henderson Community College"	"Henderson, KY"
"Hendrix College"	"Conway, AR"
"Hennepin Technical College"	"Brooklyn Park, MN"
"Henry Ford College"	"Dearborn, MI"
"Heritage University"	"Toppenish, WA"
"Herkimer County BOCES-Practical Nursing Program"	"Ilion, NY"
"Herkimer County Community College"	"Herkimer, NY"
"Hesston College"	"Hesston, KS"
"Hi-Tech School of Cosmetology"	"Miami, FL"
"Hibbing Community College"	"Hibbing, MN"
"High Plains Technology Center"	"Woodward, OK"
"High Point University"	"High Point, NC"
"Highland Community College - KS"	"Highland, KS"
"Highlands College of Montana Tech"	"Butte, MT"
"Highline Community College"	"Des Moines, WA"
"Hilbert College"	"Hamburg, NY"
"Hill College"	"Hillsboro, TX"
"Hillsborough Community College"	"Tampa, FL"
"Hilltop Beauty School"	"Daly City, CA"
"Hillyard Technical Center"	"St. Joseph, MO"
"Hiram College"	"Hiram, OH"
"Hiwassee College"	"Madisonville, TN"
"Hobart and William Smith Colleges"	"Geneva, NY"
"Hodges University"	"Naples, FL"
"Hofstra University"	"Hempstead, NY"
"Hollins University"	"Roanoke, VA"
"Holmes Community College"	"Goodman, MS"
"Holy Apostles"	"Cromwell, CT"
"Holy Cross College"	"Notre Dame, IN"
"Holy Family University"	"Philadelphia, PA"
"Holy Name Medical Center School of Nursing"	"Teaneck, NJ"
"Holy Names University"	"Oakland, CA"
"Holyoke Community College"	"Holyoke, MA"
"Homestead Schools"	"Torrance, CA"
"Hondros College of Nursing"	"Westerville, OH"
"Honolulu Community College"	"Honolulu, HI"
"Honors Beauty College"	"Indianapolis, IN"
"Hood College"	"Frederick, MD"
"Hope College"	"Holland, MI"
"Hope International University"	"Fullerton, CA"
"Hopkinsville Community College"	"Hopkinsville, KY"
"Horry-Georgetown Technical College"	"Conway, SC"
"Houghton College"	"Houghton, NY"
"Housatonic Community College"	"Bridgeport, CT"
"Houston Graduate School of Theology"	"Houston, TX"
"Houston Training School-Gulfgate"	"Houston, TX"
"Howard College"	"Big Spring, TX"
"Howard Community College"	"Columbia, MD"
"Howard Payne University"	"Brownwood, TX"
"Howard University"	"Washington D.C., DC"
"Hudson County Community College"	"Jersey City, NJ"
"Hudson Valley Community College"	"Troy, NY"
"Hult International Business School"	"Cambridge, MA"
"Humboldt State University"	"Arcata, CA"
"Huntingdon College"	"Montgomery, AL"
"Huntington Junior College"	"Huntington, WV"
"Huntington School of Beauty Culture-Main Campus"	"Huntington, WV"
"Huntington University"	"Huntington, IN"
"Huntsville Bible College"	"Huntsville, AL"
"Huston-Tillotson University"	"Austin, TX"
"Icahn School of Medicine at Mount Sinai"	"New York, NY"
"Idaho State University"	"Pocatello, ID"
"Ilisagvik College"	"Barrow, AK"
"Illinois College"	"Jacksonville, IL"
"Illinois Institute of Technology"	"Chicago, IL"
"Illinois State University"	"Normal, IL"
"Illinois Valley Community College"	"Oglesby, IL"
"Illinois Wesleyan University"	"Bloomington, IL"
"Imagine-Paul Mitchell Partner School"	"North Little Rock, AR"
"Immaculata University"	"Immaculata, PA"
"Immokalee Technical College"	"Immokalee, FL"
"Imperial Valley College"	"Imperial, CA"
"Independence Community College"	"Independence, KS"
"Indian Capital Technology Center-Muskogee"	"Muskogee, OK"
"Indian Hills Community College"	"Ottumwa, IA"
"Indiana University - East"	"Richmond, IN"
"Indiana University - Kokomo"	"Kokomo, IN"
"Indiana University - Northwest"	"Gary, IN"
"Indiana University - Purdue University Indianapolis"	"Indianapolis, IN"
"Indiana University-South Bend"	"South Bend, IN"
"Indiana University-Southeast"	"New Albany, IN"
"Inner State Beauty School"	"Lyndhurst, OH"
"Institute of American Indian Arts"	"Santa Fe, NM"
"The Institute of Beauty and Wellness"	"Milwaukee, WI"
"Institute of Health Sciences"	"Hunt Valley, MD"
"InterCoast Colleges-Fairfield"	"Fairfield, CA"
"Interior Designers Institute"	"Newport Beach, CA"
"International Academy"	"South Daytona, FL"
"International Academy of Style"	"Reno, NV"
"International Air and Hospitality Academy"	"Vancouver, WA"
"International College of Cosmetology"	"Oakland, CA"
"International Institute of Cosmetology"	"Wethersfield, CT"
"International Salon and Spa Academy"	"Colorado Springs, CO"
"International School of Beauty Inc"	"Palm Desert, CA"
"International Technological University"	"Sunnyvale, CA"
"Inver Hills Community College"	"Inver Grove Heights, MN"
"Iona College"	"New Rochelle, NY"
"Iowa Lakes Community College"	"Estherville, IA"
"Iowa State University"	"Ames, IA"
"Iowa Wesleyan University"	"Mount Pleasant, IA"
"Iowa Western Community College"	"Council Bluffs, IA"
"Irvine Valley College"	"Irvine, CA"
"Isothermal Community College"	"Spindale, NC"
"Itasca Community College"	"Grand Rapids, MN"
"Itawamba Community College"	"Fulton, MS"
"Ithaca College"	"Ithaca, NY"
"Ivy Tech Community College-Central Indiana"	"Indianapolis, IN"
"J F Drake State Community & Technical College"	"Huntsville, AL"
"J F Ingram State Technical College"	"Deatsville, AL"
"Jackson College"	"Jackson, MI"
"Jackson State Community College"	"Jackson, TN"
"Jackson State University"	"Jackson, MS"
"Jacksonville State University"	"Jacksonville, AL"
"James A Rhodes State College"	"Lima, OH"
"James H Faulkner State Community College"	"Bay Minette, AL"
"James Madison University"	"Harrisonburg, VA"
"James Rumsey Technical Institute"	"Martinsburg, WV"
"James Sprunt Community College"	"Kenansville, NC"
"Jamestown Business College"	"Jamestown, NY"
"Jamestown Community College"	"Jamestown, NY"
"Jarvis Christian College"	"Hawkins, TX"
"Jay's Technical Institute"	"Houston, TX"
"Jean Madeline Aveda Institute"	"Philadelphia, PA"
"Jefferson College"	"Hillsboro, MO"
"Jefferson College of Health Sciences"	"Roanoke, VA"
"Jefferson Community College"	"Watertown, NY"
"Jefferson State Community College"	"Birmingham, AL"
"Jersey College"	"Hackensack, NJ"
"John A Logan College"	"Carterville, IL"
"John Brown University"	"Siloam Springs, AR"
"John Carroll University"	"University Heights, OH"
"The John Marshall Law School"	"Chicago, IL"
"John Tyler Community College"	"Chester, VA"
"John Wesley International Barber and Beauty College"	"Long Beach, CA"
"John Wood Community College"	"Quincy, IL"
"Johnson & Wales University-Charlotte"	"Charlotte, NC"
"Johnson & Wales University-Denver"	"Denver, CO"
"Johnson & Wales University-North Miami"	"North Miami, FL"
"Johnson & Wales University-Providence"	"Providence, RI"
"Johnson C Smith University"	"Charlotte, NC"
"Johnson College"	"Scranton, PA"
"Johnson County Community College"	"Overland Park, KS"
"Johnson University"	"Knoxville, TN"
"Johnston Community College"	"Smithfield, NC"
"Jolie Hair & Beauty Academy-Northfield"	"Northfield, NJ"
"Jones County Junior College"	"Ellisville, MS"
"Jose Maria Vargas University"	"Pembroke Pines, FL"
"Josephs College Cosmetology"	"Lincoln, NE"
"Juniata College"	"Huntingdon, PA"
"Kairos University"	"Myerstown, PA"
"Kaizen Beauty Academy"	"Pembroke Pines, FL"
"Kalamazoo College"	"Kalamazoo, MI"
"Kalamazoo Valley Community College"	"Kalamazoo, MI"
"Kankakee Community College"	"Kankakee, IL"
"Kansas City Art Institute"	"Kansas City, MO"
"Kansas City University of Medicine and Biosciences"	"Kansas City, MO"
"Kansas State University"	"Manhattan, KS"
"Kansas Wesleyan University"	"Salina, KS"
"Kapiolani Community College"	"Honolulu, HI"
"Kaskaskia College"	"Centralia, IL"
"Kauai Community College"	"Lihue, HI"
"Kean University"	"Union, NJ"
"Keck Graduate Institute"	"Claremont, CA"
"Keene State College"	"Keene, NH"
"Keiser University - Naples"	"Naples, FL"
"Kellogg Community College"	"Battle Creek, MI"
"Kennebec Valley Community College"	"Fairfield, ME"
"Kennesaw State University"	"Kennesaw, GA"
"Kenneth Shuler School of Cosmetology"	"Greenville, SC"
"Kent State University at Ashtabula"	"Ashtabula, OH"
"Kent State University at East Liverpool"	"East Liverpool, OH"
"Kent State University at Geauga"	"Burton, OH"
"Kent State University at Salem"	"Salem, OH"
"Kent State University at Stark"	"Canton, OH"
"Kent State University at Trumbull"	"Warren, OH"
"Kent State University at Tuscarawas"	"New Philadelphia, OH"
"Kentucky Christian University"	"Grayson, KY"
"Kentucky State University"	"Frankfort, KY"
"Kenyon College"	"Gambier, OH"
"Kettering College"	"Kettering, OH"
"Kettering University"	"Flint, MI"
"Keuka College"	"Keuka Park, NY"
"Keystone College"	"La Plume, PA"
"Keystone Technical Institute"	"Harrisburg, PA"
"Kiamichi Technology Center-McAlester"	"McAlester, OK"
"Kilgore College"	"Kilgore, TX"
"King University"	"Bristol, TN"
"The King's College - NY"	"New York, NY"
"King's College - PA"	"Wilkes Barre, PA"
"The King's University"	"Van Nuys, TX"
"Kirkwood Community College"	"Cedar Rapids, IA"
"Kishwaukee College"	"Malta, IL"
"Klamath Community College"	"Klamath Falls, OR"
"Knox College"	"Galesburg, IL"
"Knox County Career Center"	"Mount Vernon, OH"
"Kutztown University of Pennsylvania"	"Kutztown, PA"
"Kuyper College"	"Grand Rapids, MI"
"L'esprit Academy"	"Livonia, MI"
"La Belle Beauty Academy"	"Miami, FL"
"La Belle Beauty School"	"Hialeah, FL"
"LA Film School"	"Los Angeles, CA"
"La Roche College"	"Pittsburgh, PA"
"La Sierra University"	"Riverside, CA"
"Labette Community College"	"Parsons, KS"
"Laboure College"	"Boston, MA"
"Lac Courte Oreilles Ojibwa Community College"	"Hayward, WI"
"Lackawanna College"	"Scranton, PA"
"Lafayette College"	"Easton, PA"
"LaGrange College"	"Lagrange, GA"
"Laguna College of Art and Design"	"Laguna Beach, CA"
"Lake Area Technical College"	"Watertown, SD"
"Lake Erie College"	"Painesville, OH"
"Lake Erie College of Osteopathic Medicine"	"Erie, PA"
"Lake Forest College"	"Lake Forest, IL"
"Lake Land College"	"Mattoon, IL"
"Lake Lanier School of Massage"	"Gainsville, GA"
"Lake Michigan College"	"Benton Harbor, MI"
"Lake Region State College"	"Devils Lake, ND"
"Lake Superior College"	"Duluth, MN"
"Lake Superior State University"	"Sault Ste Marie, MI"
"Lake Tahoe Community College"	"South Lake Tahoe, CA"
"Lake Technical Center"	"Eustis, FL"
"Lake Washington Institute of Technology"	"Kirkland, WA"
"Lake-Sumter Community College"	"Leesburg, FL"
"Lakeland Community College"	"Kirtland, OH"
"Lakeland University"	"Plymouth, WI"
"Lakes Region Community College"	"Laconia, NH"
"Lakeshore Technical College"	"Cleveland, WI"
"Lakeview College of Nursing"	"Danville, IL"
"Lamar Community College"	"Lamar, CO"
"Lamar Institute of Technology"	"Beaumont, TX"
"Lamar State College-Orange"	"Orange, TX"
"Lamar State College-Port Arthur"	"Port Arthur, TX"
"Lancaster Beauty School"	"Lancaster, CA"
"Lancaster County Career and Technology Center"	"Willow Street, PA"
"Lancaster School of Cosmetology"	"Lancaster, PA"
"Landmark College"	"Putney, VT"
"Lane College"	"Jackson, TN"
"Lane Community College"	"Eugene, OR"
"Laney College"	"Oakland, CA"
"Langston University"	"Langston, OK"
"Lansing Community College"	"Lansing, MI"
"Laramie County Community College"	"Cheyenne, WY"
"Laredo Beauty College Inc"	"Laredo, TX"
"Laredo Community College"	"Laredo, TX"
"Las Positas College"	"Livermore, CA"
"Las Vegas College"	"Henderson, NV"
"Lassen Community College"	"Susanville, CA"
"Latter-day Saints Business College"	"Salt Lake City, UT"
"Laurel Business Institute"	"Uniontown, PA"
"Laurus College"	"San Luis Obispo, CA"
"Lawrence Memorial Hospital School of Nursing"	"Medford, MA"
"Lawrence Technological University"	"Southfield, MI"
"Lawrence University"	"Appleton, WI"
"Lawson State Community College-Birmingham Campus"	"Birmingham, AL"
"Le Moyne College"	"Syracuse, NY"
"Le Moyne-Owen College"	"Memphis, TN"
"Lebanon County Area Vocational Technical School"	"Lebanon, PA"
"Lebanon Valley College"	"Annville, PA"
"Lee College"	"Baytown, TX"
"Lee County High Tech Center Central"	"Fort Myers, FL"
"Lee County High Tech Center North"	"Cape Coral, FL"
"Lee University"	"Cleveland, TN"
"Leech Lake Tribal College"	"Cass Lake, MN"
"Lees-McRae College"	"Banner Elk, NC"
"Leeward Community College"	"Pearl City, HI"
"Lehigh Carbon Community College"	"Schnecksville, PA"
"Lenoir Community College"	"Kinston, NC"
"Lenoir-Rhyne University"	"Hickory, NC"
"Leons Beauty School Inc"	"Greensboro, NC"
"Lesley University"	"Cambridge, MA"
"Lewis & Clark College"	"Portland, OR"
"Lewis-Clark State College"	"Lewiston, ID"
"Lewistown Hospital School of Nursing"	"Lewistown, PA"
"Lexington Healing Arts Academy"	"Lexington, KY"
"Liberty University Campus"	"Lynchburg, VA"
"Life Chiropractic College West"	"Hayward, CA"
"Life Pacific University"	"San Dimas, CA"
"Life University"	"Marietta, GA"
"LIM College"	"New York, NY"
"Limestone University"	"Gaffney, SC"
"Lincoln Christian University"	"Lincoln, IL"
"Lincoln College"	"Lincoln, IL"
"Lincoln Land Community College"	"Springfield, IL"
"Lincoln Memorial University"	"Harrogate, TN"
"Lincoln University - CA"	"Oakland, CA"
"Lincoln University - MO"	"Jefferson City, MO"
"Lincoln University of Pennsylvania"	"Lincoln University, PA"
"Lindsey Hopkins Technical Education Center"	"Miami, FL"
"Lindsey Wilson College"	"Columbia, KY"
"Linfield University"	"McMinnville, OR"
"Linfield University-Nursing & Health Sciences"	"Portland, OR"
"Linfield University-Online and Continuing Education"	"McMinnville, OR"
"Linn-Benton Community College"	"Albany, OR"
"Lipscomb University"	"Nashville, TN"
"Little Big Horn College"	"Crow Agency, MT"
"Little Priest Tribal College"	"Winnebago, NE"
"Lively Technical Center"	"Tallahassee, FL"
"Livingstone College"	"Salisbury, NC"
"Lock Haven University"	"Lock Haven, PA"
"Logan University"	"Chesterfield, MO"
"Loma Linda University"	"Loma Linda, CA"
"Long Beach City College"	"Long Beach, CA"
"Long Island Business Institute"	"Flushing, NY"
"Long Island Nail & Skin Care Institute"	"Levittown, NY"
"Long Island University"	"Brookville, NY"
"Longy School of Music"	"Cambridge, MA"
"Lorain County Community College"	"Elyria, OH"
"Lorain County Joint Vocational School District"	"Oberlin, OH"
"Loraines Academy Inc"	"St. Petersburg, FL"
"Loras College"	"Dubuque, IA"
"Lord Fairfax Community College"	"Middletown, VA"
"Lorenzo Walker Technical College"	"Naples, FL"
"Los Angeles City College"	"Los Angeles, CA"
"Los Angeles College of Music"	"Pasadena, CA"
"Los Angeles County College of Nursing and Allied Health"	"Los Angeles, CA"
"Los Angeles Harbor College"	"Wilmington, CA"
"Los Angeles Mission College"	"Sylmar, CA"
"Los Angeles Pierce College"	"Woodland Hills, CA"
"Los Angeles Southwest College"	"Los Angeles, CA"
"Los Angeles Trade Technical College"	"Los Angeles, CA"
"Los Angeles Valley College"	"Valley Glen, CA"
"Louisburg College"	"Louisburg, NC"
"Louisiana College"	"Pineville, LA"
"Louisiana Delta Community College"	"Monroe, LA"
"Louisiana State University"	"Baton Rouge, LA"
"Louisiana State University Health Sciences Center-New Orleans"	"New Orleans, LA"
"Louisiana State University Health Sciences Center-Shreveport"	"Shreveport, LA"
"Louisiana State University-Eunice"	"Eunice, LA"
"Louisiana Tech University"	"Ruston, LA"
"Louisville Presbyterian Theological Seminary"	"Louisville, KY"
"Lourdes University"	"Sylvania, OH"
"Lowell Academy Hairstyling Institute"	"Lowell, MA"
"Lower Columbia College"	"Longview, WA"
"Loyola University Chicago"	"Chicago, IL"
"Loyola University Maryland"	"Baltimore, MD"
"Lu Ross Academy"	"Ventura, CA"
"Lubbock Christian University"	"Lubbock, TX"
"Lucas Marc Academy"	"Richland, WA"
"Luna Community College"	"Las Vegas, NM"
"Luther College"	"Decorah, IA"
"Luther Rice College & Seminary"	"Lithonia, GA"
"Lutheran School of Nursing"	"St. Louis, MO"
"Lutheran School of Theology at Chicago"	"Chicago, IL"
"Luzerne County Community College"	"Nanticoke, PA"
"Lycoming College"	"Williamsport, PA"
"Lynchburg General Hospital School of Nursing"	"Lynchburg, VA"
"Lyon College"	"Batesville, AR"
"Lytles Redwood Empire Beauty College Inc"	"Santa Rosa, CA"
"M T Training Center"	"Grand Prairie, TX"
"M-DCPS The English Center"	"Miami, FL"
"Macalester College"	"Saint Paul, MN"
"MacCormac College"	"Chicago, IL"
"Madison Adult Career Center"	"Mansfield, OH"
"Madison Area Technical College"	"Madison, WI"
"Madison Media Institute"	"Madison, WI"
"Madisonville Community College"	"Madisonville, KY"
"Madonna University"	"Livonia, MI"
"Magnolia College of Cosmetology"	"Jackson, MS"
"Magnolia school"	"Ambler, PA"
"Maharishi International University"	"Fairfield, IA"
"Maine College of Art"	"Portland, ME"
"Maine College of Health Professions"	"Lewiston, ME"
"Maine Maritime Academy"	"Castine, ME"
"Make-up Designory"	"Burbank, CA"
"Malone University"	"Canton, OH"
"Management Resources Institute"	"Miami, FL"
"Manatee Technical College"	"Bradenton, FL"
"Manchester Community College - CT"	"Manchester, CT"
"Manchester Community College - NH"	"Manchester, NH"
"Manchester University"	"North Manchester, IN"
"Mandl The College of Allied Health"	"New York, NY"
"Manhattan Area Technical College"	"Manhattan, KS"
"Manhattan Christian College"	"Manhattan, KS"
"Manhattan Institute (The)"	"New York, NY"
"Manhattan School of Computer Technology"	"Brooklyn, NY"
"Manhattanville College"	"Purchase, NY"
"Manor College"	"Jenkintown, PA"
"Mansfield University of Pennsylvania"	"Mansfield, PA"
"Maranatha Baptist University"	"Watertown, WI"
"Marchman Technical Education Center"	"New Port Richey, FL"
"Maria College of Albany"	"Albany, NY"
"Marian Health Careers Center-Van Nuys Campus"	"Van Nuys, CA"
"Marian University"	"Indianapolis, IN"
"Marian University - Wisconsin"	"Fond du Lac, WI"
"Maricopa Skill Center"	"Phoenix, AZ"
"Marietta College"	"Marietta, OH"
"Marine Mechanics Institute"	"Orlando, FL"
"Marion Technical College"	"Marion, OH"
"Marion Technical College - FL"	"Ocala, FL"
"Marist College"	"Poughkeepsie, NY"
"Marlboro College"	"Marlboro, VT"
"Marlboro College Graduate School"	"Brattleboro, VT"
"Marquette University"	"Milwaukee, WI"
"Mars Hill University"	"Mars Hill, NC"
"Marshall B. Ketchum University"	"Fullerton, CA"
"Marshall University"	"Huntington, WV"
"Marshalltown Community College"	"Marshalltown, IA"
"Martin Community College"	"Williamston, NC"
"Martin Luther College"	"New Ulm, MN"
"Martin Methodist College"	"Pulaski, TN"
"Martin University"	"Indianapolis, IN"
"Mary Baldwin University"	"Staunton, VA"
"Marygrove College"	"Detroit, MI"
"Maryland Institute College of Art"	"Baltimore, MD"
"Maryland University of Integrative Health"	"Laurel, MD"
"Marymount Manhattan College"	"New York, NY"
"Maryville College"	"Maryville, TN"
"Marywood University"	"Scranton, PA"
"Massachusetts Bay Community College"	"Wellesley Hills, MA"
"Massachusetts College of Art and Design"	"Boston, MA"
"Massachusetts College of Liberal Arts"	"North Adams, MA"
"Massachusetts College of Pharmacy and Health Sciences"	"Boston, MA"
"Massachusetts Institute of Technology"	"Cambridge, MA"
"Massachusetts School of Law"	"Andover, MA"
"Massasoit Community College"	"Brockton, MA"
"The Master's University"	"Santa Clarita, CA"
"Mayfield College"	"Cathedral City, CA"
"Mayland Community College"	"Spruce Pine, NC"
"Mayo Medical School"	"Rochester, MN"
"Maysville Community and Technical College"	"Maysville, KY"
"Mayville State University"	"Mayville, ND"
"McCormick Theological Seminary"	"Chicago, IL"
"McDaniel College"	"Westminster, MD"
"McDowell Technical Community College"	"Marion, NC"
"McFatter Technical College"	"Davie, FL"
"McHenry County College"	"Crystal Lake, IL"
"McKendree University"	"Lebanon, IL"
"McLennan Community College"	"Waco, TX"
"McMurry University"	"Abilene, TX"
"McNeese State University"	"Lake Charles, LA"
"McPherson College"	"McPherson, KS"
"The Medical Arts School"	"Raleigh, NC"
"Medical College of Wisconsin"	"Milwaukee, WI"
"Medical Institute of Palm Beach"	"Greenacres, FL"
"Medical Training College"	"Baton Rouge, LA"
"Medical University of South Carolina"	"Charleston, SC"
"Meharry Medical College"	"Nashville, TN"
"Memorial Hospital School of Nursing"	"Albany, NY"
"Memphis College of Art"	"Memphis, TN"
"Memphis Theological Seminary"	"Memphis, TN"
"Mendocino College"	"Ukiah, CA"
"Menlo College"	"Atherton, CA"
"Merced College"	"Merced, CA"
"Mercer County Technical Education Center"	"Princeton, WV"
"Mercer University"	"Macon, GA"
"Mercy College"	"Dobbs Ferry, NY"
"Mercy College of Health Sciences"	"Des Moines, IA"
"Mercy College of Northwest Ohio"	"Toledo, OH"
"Mercy Hospital School of Nursing"	"Pittsburgh, PA"
"Mercy Hospital School of Practical Nursing"	"Miami, FL"
"Meredith College"	"Raleigh, NC"
"Meridian College"	"Sarasota, FL"
"Meridian Community College"	"Meridian, MS"
"Meridian Institute of Surgical Assisting"	"Nashville, TN"
"Meridian Technology Center"	"Stillwater, OK"
"Merkaz Bnos-Business School"	"Brooklyn, NY"
"Merrell University of Beauty Arts and Science"	"Jefferson City, MO"
"Merrimack College"	"North Andover, MA"
"Merritt College"	"Oakland, CA"
"Mesa Community College"	"Mesa, AZ"
"Mesabi Range College"	"Virginia, MN"
"Mesalands Community College"	"Tucumcari, NM"
"Methodist College"	"Peoria, IL"
"Methodist Theological School in Ohio"	"Delaware, OH"
"Methodist University"	"Fayetteville, NC"
"Metro Beauty Academy"	"Allentown, PA"
"Metro Technology Centers"	"Oklahoma City, OK"
"Metropolitan College of New York"	"New York, NY"
"Metropolitan Community College"	"Omaha, NE"
"Metropolitan Community College-Longview"	"Lees Summit, MO"
"Metropolitan Learning Institute"	"Rego Park, NY"
"Metropolitan State University"	"Saint Paul, MN"
"Metropolitan State University of Denver"	"Denver, CO"
"MGH Institute of Health Professions"	"Boston, MA"
"Miami Lakes Educational Center"	"Miami Lakes, FL"
"Miami University - Oxford"	"Oxford, OH"
"Miami Valley Career Technology Center"	"Clayton, OH"
"Michaels School of Hair Design and Esthetics-Paul Mitchell Partner School"	"Bedford, NH"
"Michigan Career and Technical Institute"	"Plainwell, MI"
"Michigan School of Psychology"	"Farmington Hills, MI"
"Michigan State University College of Law"	"East Lansing, MI"
"Mid Michigan College"	"Harrison, MI"
"Mid-America Technology Center"	"Wayne, OK"
"Mid-Atlantic Christian University"	"Elizabeth City, NC"
"Mid-Plains Community College"	"North Platte, NE"
"Mid-South Community College"	"West Memphis, AR"
"Mid-State Technical College"	"Wisconsin Rapids, WI"
"MidAmerica Nazarene University"	"Olathe, KS"
"Middle Georgia State University"	"Macon, GA"
"Middle Tennessee School of Anesthesia"	"Madison, TN"
"Middle Tennessee State University"	"Murfreesboro, TN"
"Middlebury College"	"Middlebury, VT"
"Middlebury Institute of International Studies at Monterey"	"Monterey, CA"
"Middlesex Community College - CT"	"Middletown, CT"
"Middlesex County College"	"Edison, NJ"
"Midland College"	"Midland, TX"
"Midland University"	"Fremont, NE"
"Midlands Technical College"	"West Columbia, SC"
"Midwest Technical Institute-Springfield"	"Springfield, MO"
"Midwestern Baptist Theological Seminary"	"Kansas City, MO"
"Midwestern State University"	"Wichita Falls, TX"
"Midwestern University-Downers Grove"	"Downers Grove, IL"
"Midwestern University-Glendale"	"Glendale, AZ"
"Midwives College of Utah"	"Salt Lake City, UT"
"Milan Institute-Las Vegas"	"Las Vegas, NV"
"Milan Institute-Merced"	"Merced, CA"
"Miles College"	"Fairfield, AL"
"Miles Community College"	"Miles City, MT"
"Millersville University of Pennsylvania"	"Millersville, PA"
"Millikin University"	"Decatur, IL"
"Mills College"	"Oakland, CA"
"Millsaps College"	"Jackson, MS"
"Milwaukee Area Technical College"	"Milwaukee, WI"
"Milwaukee Institute of Art & Design"	"Milwaukee, WI"
"Mineral Area College"	"Park Hills, MO"
"Minneapolis College of Art and Design"	"Minneapolis, MN"
"Minneapolis Community and Technical College"	"Minneapolis, MN"
"Minnesota State College Southeast"	"Winona, MN"
"Minnesota State University - Moorhead"	"Moorhead, MN"
"Minnesota State University at Mankato"	"Mankato, MN"
"Minnesota West Community and Technical College"	"Granite Falls, MN"
"Minot State University"	"Minot, ND"
"MiraCosta College"	"Oceanside, CA"
"Misericordia University"	"Dallas, PA"
"Mission College"	"Santa Clara, CA"
"Mississippi Delta Community College"	"Moorhead, MS"
"Mississippi Gulf Coast Community College"	"Perkinston, MS"
"Mississippi State University"	"Mississippi State, MS"
"Mississippi Valley State University"	"Itta Bena, MS"
"Missouri Baptist University"	"St. Louis, MO"
"Missouri College"	"Brentwood, MO"
"Missouri Southern State University"	"Joplin, MO"
"Missouri State University"	"Springfield, MO"
"Missouri State University-West Plains"	"West Plains, MO"
"Missouri University of Science and Technology"	"Rolla, MO"
"Missouri Valley College"	"Marshall, MO"
"Missouri Western State University"	"St. Joseph, MO"
"Mitchell College"	"New London, CT"
"Mitchell Community College"	"Statesville, NC"
"Mitchell Hamline School of Law"	"Saint Paul, MN"
"Mitchell Technical Institute"	"Mitchell, SD"
"Moberly Area Community College"	"Moberly, MO"
"Model College of Hair Design"	"St. Cloud, MN"
"The Modern College of Design"	"Kettering, OH"
"Modesto Junior College"	"Modesto, CA"
"Mohave Community College"	"Kingman, AZ"
"Mohawk Valley Community College-Utica Branch"	"Utica, NY"
"Molloy College"	"Rockville Centre, NY"
"Monmouth College"	"Monmouth, IL"
"Monmouth County Vocational School District"	"Neptune, NJ"
"Monmouth University"	"West Long Branch, NJ"
"Monroe Community College"	"Rochester, NY"
"Monroe County Community College"	"Monroe, MI"
"Montana State University"	"Bozeman, MT"
"Montana State University - Billings"	"Billings, MT"
"Montana State University - Northern"	"Havre, MT"
"Montana State University-Great Falls College of Technology"	"Great Falls, MT"
"Montana Technological University"	"Butte, MT"
"Montcalm Community College"	"Sidney, MI"
"Monterey Peninsula College"	"Monterey, CA"
"Montgomery Beauty School"	"Silver Spring, MD"
"Montgomery Community College"	"Troy, NC"
"Montgomery County Community College"	"Blue Bell, PA"
"Montserrat College of Art"	"Beverly, MA"
"Moody Bible Institute"	"Chicago, IL"
"Moore College of Art and Design"	"Philadelphia, PA"
"Moore Norman Technology Center"	"Norman, OK"
"Moorpark College"	"Moorpark, CA"
"Moraine Park Technical College"	"Fond du Lac, WI"
"Moraine Valley Community College"	"Palos Hills, IL"
"Moravian College and Moravian Theological Seminary"	"Bethlehem, PA"
"Morehead State University"	"Morehead, KY"
"Morehouse College"	"Atlanta, GA"
"Morehouse School of Medicine"	"Atlanta, GA"
"Moreno Valley College"	"Moreno Valley, CA"
"Morgan Community College"	"Fort  Morgan, CO"
"Morgan State University"	"Baltimore, MD"
"Morningside College"	"Sioux City, IA"
"Morris College"	"Sumter, SC"
"Morton College"	"Cicero, IL"
"Motlow State Community College"	"Tullahoma, TN"
"Mott Community College"	"Flint, MI"
"Mount Aloysius College"	"Cresson, PA"
"Mount Carmel College of Nursing"	"Columbus, OH"
"Mount Holyoke College"	"South Hadley, MA"
"Mount Marty College"	"Yankton, SD"
"Mount Mary University"	"Milwaukee, WI"
"Mount Saint Mary College"	"Newburgh, NY"
"Mount Saint Mary's University - CA"	"Los Angeles, CA"
"Mount St. Joseph University"	"Cincinnati, OH"
"Mount St. Mary's University - MD"	"Emmitsburg, MD"
"Mountain Empire Community College"	"Big Stone Gap, VA"
"Mountain State College"	"Parkersburg, WV"
"Mountain View College"	"Dallas, TX"
"Mountwest Community and Technical College"	"Huntington, WV"
"Mt Diablo Adult Education"	"Concord, CA"
"Mt Hood Community College"	"Gresham, OR"
"Mt. San Antonio College"	"Walnut, CA"
"MTI College"	"Sacramento, CA"
"Muhlenberg College"	"Allentown, PA"
"Muhlenberg Harold B & Dorothy A Snyder Schools-School of Nursing"	"Plainfield, NJ"
"Multnomah University"	"Portland, OR"
"Murray State College"	"Tishomingo, OK"
"Musicians Institute"	"Hollywood, CA"
"Muskegon Community College"	"Muskegon, MI"
"Muskingum University"	"New Concord, OH"
"MyComputerCareer.com"	"Raleigh, NC"
"Napa Valley College"	"Napa, CA"
"Naropa University"	"Boulder, CO"
"NASCAR Technical Institute"	"Mooresville, NC"
"Nash Community College"	"Rocky Mount, NC"
"Nashua Community College"	"Nashua, NH"
"Nashville Auto Diesel College (NADC)"	"Nashville, TN"
"Nashville College of Medical Careers"	"Madison, TN"
"Nashville State Community College"	"Nashville, TN"
"Nassau Community College"	"Garden City, NY"
"National Beauty College - CO"	"Denver, CO"
"National Career Education"	"Rancho Cordova, CA"
"National College of Natural Medicine"	"Portland, OR"
"National Graduate School of Quality Management"	"Falmouth, MA"
"National Paralegal College"	"Phoenix, AZ"
"National Park College"	"Hot Springs, AR"
"National Polytechnic College"	"Commerce, CA"
"National University"	"La Jolla, CA"
"National University of Health Sciences"	"Lombard, IL"
"Naugatuck Valley Community College"	"Waterbury, CT"
"Navajo Technical College"	"Crownpoint, NM"
"Naval Postgraduate School"	"Monterey, CA"
"Nazarene Bible College"	"Colorado Springs, CO"
"Nazarene Theological Seminary"	"Kansas City, MO"
"Nazareth College"	"Rochester, NY"
"Nebraska Christian College"	"Papillion, NE"
"Nebraska College of Technical Agriculture"	"Curtis, NE"
"Nebraska Indian Community College"	"Macy, NE"
"Nebraska Methodist College"	"Omaha, NE"
"Nebraska Wesleyan University"	"Lincoln, NE"
"Neosho County Community College"	"Chanute, KS"
"Neumann University"	"Aston, PA"
"Nevada Career Institute"	"Las Vegas, NV"
"New Age Training"	"New York, NY"
"New Beginning College of Cosmetology"	"Albertville, AL"
"New Brunswick Theological Seminary"	"New Brunswick, NJ"
"New College of Florida"	"Sarasota, FL"
"New Community Career & Technical Institute"	"Newark, NJ"
"New England College of Optometry"	"Boston, MA"
"New England Hair Academy"	"Malden, MA"
"New England Institute of Technology"	"East Greenwich, RI"
"New England Law-Boston"	"Boston, MA"
"New England Tractor Trailer Training School of Massachusetts"	"North Andover, MA"
"New Hope Christian College"	"Eugene, OR"
"New Jersey City University"	"Jersey City, NJ"
"New Jersey Institute of Technology"	"Newark, NJ"
"New Mexico Highlands University"	"Las Vegas, NM"
"New Mexico Institute of Mining and Technology"	"Socorro, NM"
"New Mexico Junior College"	"Hobbs, NM"
"New Mexico State University"	"Las Cruces, NM"
"New Mexico State University-Alamogordo"	"Alamogordo, NM"
"New Mexico State University-Carlsbad"	"Carlsbad, NM"
"New Mexico State University-Dona Ana"	"Las Cruces, NM"
"New Mexico State University-Grants"	"Grants, NM"
"New Orleans Baptist Theological Seminary"	"New Orleans, LA"
"New River Community and Technical College"	"Beckley, WV"
"New River Community College"	"Dublin, VA"
"New Saint Andrews College"	"Moscow, ID"
"The New School"	"New York, NY"
"New School Center for Media"	"Albany, NY"
"New York Academy of Art"	"New York, NY"
"New York Automotive & Diesel Institute"	"Jamaica, NY"
"New York Chiropractic College"	"Seneca Falls, NY"
"New York College of Health Professions"	"Syosset, NY"
"New York College of Podiatric Medicine"	"New York, NY"
"New York College of Traditional Chinese Medicine"	"Mineola, NY"
"New York Law School"	"New York, NY"
"New York Medical College"	"Valhalla, NY"
"New York Methodist Hospital Center for Allied Health Education"	"Brooklyn, NY"
"New York School of Interior Design"	"New York, NY"
"Newberry College"	"Newberry, SC"
"Newberry School of Beauty"	"Granada Hills, CA"
"Newman University"	"Wichita, KS"
"Newschool of Architecture and Design"	"San Diego, CA"
"NHTI-Concord's Community College"	"Concord, NH"
"Niagara County Community College"	"Sanborn, NY"
"Niagara University"	"Niagara University, NY"
"Nicholls State University"	"Thibodaux, LA"
"Nichols College"	"Dudley, MA"
"Nicolet Area Technical College"	"Rhinelander, WI"
"Nightingale College"	"Ogden, UT"
"Norco College"	"Norco, CA"
"Normandale Community College"	"Bloomington, MN"
"North Adrians Beauty College"	"Modesto, CA"
"North American College"	"Houston, TX"
"North Arkansas College"	"Harrison, AR"
"North Bennet Street School"	"Boston, MA"
"North Carolina A&T State University"	"Greensboro, NC"
"North Carolina Central University"	"Durham, NC"
"North Carolina State University"	"Raleigh, NC"
"North Central College"	"Naperville, IL"
"North Central Michigan College"	"Petoskey, MI"
"North Central Missouri College"	"Trenton, MO"
"North Central State College"	"Mansfield, OH"
"North Central Texas College"	"Gainesville, TX"
"North Central University"	"Minneapolis, MN"
"The North Coast College"	"Lakewood, OH"
"North Country Community College"	"Saranac Lake, NY"
"North Dakota State College of Science"	"Wahpeton, ND"
"North Dakota State University - Main Campus"	"Fargo, ND"
"North Florida Community College"	"Madison, FL"
"North Florida Cosmetology Institute Inc"	"Tallahassee, FL"
"North Greenville University"	"Tigerville, SC"
"North Hennepin Community College"	"Brooklyn Park, MN"
"North Idaho College"	"Coeur d'Alene, ID"
"North Iowa Area Community College"	"Mason City, IA"
"North Lake College"	"Irving, TX"
"North Park University-Chicago"	"Chicago, IL"
"North Seattle College"	"Seattle, WA"
"Northampton County Area Community College"	"Bethlehem, PA"
"Northcentral Technical College"	"Wausau, WI"
"Northcoast Medical Training Academy"	"Kent, OH"
"Northeast Alabama Community College"	"Rainsville, AL"
"Northeast Community College"	"Norfolk, NE"
"Northeast Iowa Community College-Calmar"	"Calmar, IA"
"Northeast Mississippi Community College"	"Booneville, MS"
"Northeast Ohio Medical University"	"Rootstown, OH"
"Northeast State Community College"	"Blountville, TN"
"Northeast Technical Institute"	"Scarborough, ME"
"Northeast Technology Center-Afton"	"Afton, OK"
"Northeast Technology Center-Kansas"	"Kansas, OK"
"Northeast Technology Center-Pryor"	"Pryor, OK"
"Northeast Technology CenterClaremore"	"Claremore, OK"
"Northeast Texas Community College"	"Mount Pleasant, TX"
"Northeast Wisconsin Technical College"	"Green Bay, WI"
"Northeastern Illinois University"	"Chicago, IL"
"Northeastern Junior College"	"Sterling, CO"
"Northeastern Oklahoma A&M College"	"Miami, OK"
"Northeastern State University"	"Tahlequah, OK"
"Northeastern Technical College"	"Cheraw, SC"
"Northeastern University Global Network"	"Boston, MA"
"Northern Baptist Theological Seminary"	"Lombard, IL"
"Northern Maine Community College"	"Presque Isle, ME"
"Northern Michigan University"	"Marquette, MI"
"Northern New Mexico College"	"Espanola, NM"
"Northern Oklahoma College"	"Tonkawa, OK"
"Northern State University"	"Aberdeen, SD"
"Northern Vermont University"	"Johnson, VT"
"Northern Virginia Community College"	"Annandale, VA"
"Northhaven Academy"	"North Haven, CT"
"Northland College"	"Ashland, WI"
"Northshore Technical Community College"	"Bogalusa, LA"
"NorthWest Arkansas Community College"	"Bentonville, AR"
"Northwest Career College"	"Las Vegas, NV"
"Northwest College - WY"	"Powell, WY"
"Northwest Educational Center"	"Houston, TX"
"Northwest Indian College"	"Bellingham, WA"
"Northwest Iowa Community College"	"Sheldon, IA"
"Northwest Kansas Technical College"	"Goodland, KS"
"Northwest Louisiana Technical College"	"Minden, LA"
"Northwest Mississippi Community College"	"Senatobia, MS"
"Northwest Nazarene University"	"Nampa, ID"
"Northwest State Community College"	"Archbold, OH"
"Northwest Technical College"	"Bemidji, MN"
"Northwest Technical Institute - AR"	"Springdale, AR"
"Northwest University"	"Kirkland, WA"
"Northwest Vista College"	"San Antonio, TX"
"Northwestern College - IA"	"Orange City, IA"
"Northwestern Connecticut Community College"	"Winsted, CT"
"Northwestern Health Sciences University"	"Bloomington, MN"
"Northwestern Michigan College"	"Traverse City, MI"
"Northwestern Oklahoma State University"	"Alva, OK"
"Northwestern Polytechnic University"	"Fremont, CA"
"Northwestern State University of Louisiana"	"Natchitoches, LA"
"Northwestern Technological Institute"	"Southfield, MI"
"Northwood University-Michigan"	"Midland, MI"
"Norwalk Community College"	"Norwalk, CT"
"Notre Dame College"	"Cleveland, OH"
"Notre Dame of Maryland University"	"Baltimore, MD"
"Nouvelle Institute"	"Miami, FL"
"NRI Institute of Health Sciences"	"Royal Palm Beach, FL"
"NTMA Training Centers of Southern California"	"Santa Fe Springs, CA"
"Nueta Hidatsa Sahnish College"	"New Town, ND"
"Nunez Community College"	"Chalmette, LA"
"Nyack College"	"Nyack, NY"
"O C Collins Career Center"	"Chesapeake, OH"
"Oak Hills Christian College"	"Bemidji, MN"
"Oakland City University"	"Oakland City, IN"
"Oakland University"	"Rochester Hills, MI"
"Oakwood University"	"Huntsville, AL"
"Oberlin College"	"Oberlin, OH"
"Occidental College"	"Los Angeles, CA"
"Ocean County Vocational-Technical School"	"Toms River, NJ"
"Oconee Fall Line Technical College"	"Sandersville, GA"
"Odessa College"	"Odessa, TX"
"Ogden-Weber Applied Technology College"	"Ogden, UT"
"Ogeechee Technical College"	"Statesboro, GA"
"Oglala Lakota College"	"Kyle, SD"
"Ogle School Hair Skin Nails-Denton"	"Denton, TX"
"Ogle School Hair Skin Nails-North Dallas"	"Dallas, TX"
"Ogle School Hair Skin Nails-San Antonio"	"San Antonio, TX"
"Oglethorpe University"	"Atlanta, GA"
"Ohio Dominican University"	"Columbus, OH"
"Ohio Northern University"	"Ada, OH"
"Ohio State Beauty Academy"	"Lima, OH"
"Ohio State University - Main Campus"	"Columbus, OH"
"Ohio State University Agricultural Technical Institute"	"Wooster, OH"
"Ohio State University-Lima Campus"	"Lima, OH"
"Ohio State University-Mansfield Campus"	"Mansfield, OH"
"Ohio State University-Marion Campus"	"Marion, OH"
"Ohio State University-Newark Campus"	"Newark, OH"
"Ohio Technical College"	"Cleveland, OH"
"Ohio University - Zanesville Campus"	"Zanesville, OH"
"Ohio University-Chillicothe Campus"	"Chillicothe, OH"
"Ohio University-Eastern Campus"	"St. Clairsville, OH"
"Ohio University-Lancaster Campus"	"Lancaster, OH"
"Ohio University-Southern Campus"	"Ironton, OH"
"Ohio Valley University"	"Vienna, WV"
"Ohio Wesleyan University"	"Delaware, OH"
"Ohlone College"	"Fremont, CA"
"Oklahoma Baptist University"	"Shawnee, OK"
"Oklahoma Christian University"	"Edmond, OK"
"Oklahoma City Community College"	"Oklahoma City, OK"
"Oklahoma City University"	"Oklahoma City, OK"
"Oklahoma Panhandle State University"	"Goodwell, OK"
"Oklahoma State University - Main Campus"	"Stillwater, OK"
"Oklahoma State University - Oklahoma City"	"Oklahoma City, OK"
"Oklahoma State University Center for Health Sciences"	"Tulsa, OK"
"Oklahoma State University Institute of Technology"	"Okmulgee, OK"
"Oklahoma Technical College"	"Tulsa, OK"
"Oklahoma Wesleyan University"	"Bartlesville, OK"
"Old Dominion University"	"Norfolk, VA"
"Oliver Finley Academy of Cosmetology"	"Boise, ID"
"Olivet College"	"Olivet, MI"
"Olney Central College"	"Olney, IL"
"Olympian University of Cosmetology"	"Alamogordo, NM"
"Omnitech Institute"	"Decatur, GA"
"Onondaga Community College"	"Syracuse, NY"
"Onondaga Cortland Madison BOCES"	"Liverpool, NY"
"Oral Roberts University"	"Tulsa, OK"
"Orange Coast College"	"Costa Mesa, CA"
"Orange County Community College"	"Middletown, NY"
"Orange Technical College-Mid Florida Campus"	"Orlando, FL"
"Orangeburg Calhoun Technical College"	"Orangeburg, SC"
"Oregon Coast Community College"	"Newport, OR"
"Oregon College of Oriental Medicine"	"Portland, OR"
"Oregon Culinary Institute"	"Portland, OR"
"Oregon Health & Science University"	"Portland, OR"
"Oregon Institute of Technology"	"Klamath Falls, OR"
"Oregon State University"	"Corvallis, OR"
"Orlando Tech"	"Orlando, FL"
"Orleans Technical Institute"	"Philadelphia, PA"
"Orlo School of Hair Design and Cosmetology"	"Albany, NY"
"Otero Junior College"	"La Junta, CO"
"Otis College of Art and Design"	"Los Angeles, CA"
"Ottawa University Online"	"Ottawa, KS"
"Otterbein University"	"Westerville, OH"
"Ouachita Baptist University"	"Arkadelphia, AR"
"Owens Community College"	"Perrysburg, OH"
"Owensboro Community and Technical College"	"Owensboro, KY"
"Oxford Graduate School"	"Dayton, TN"
"Oxnard College"	"Oxnard, CA"
"Ozarka College"	"Melbourne, AR"
"Ozarks Technical Community College"	"Springfield, MO"
"P B Cosmetology Education Center"	"Gloucester, NJ"
"P&A Scholars Beauty School"	"Detroit, MI"
"Pace University"	"New York, NY"
"Pacific Lutheran University"	"Tacoma, WA"
"Pacific Northwest College of Art"	"Portland, OR"
"Pacific Northwest University of Health Sciences"	"Yakima, WA"
"Pacific Rim Christian College"	"Honolulu, HI"
"Pacific States University"	"Los Angeles, CA"
"Pacific Union College"	"Angwin, CA"
"Pacific University"	"Forest Grove, OR"
"Pacifica Graduate Institute"	"Carpinteria, CA"
"Paier College of Art Inc"	"Hamden, CT"
"Paine College"	"Augusta, GA"
"Palace Beauty College"	"Los Angeles, CA"
"Palm Beach Academy of Health & Beauty"	"Lake Park, FL"
"Palmer College of Chiropractic-Davenport"	"Davenport, IA"
"Palo Alto College"	"San Antonio, TX"
"Palo Alto University"	"Palo Alto, CA"
"Palo Verde College"	"Blythe, CA"
"Palomar College"	"San Marcos, CA"
"Palomar Institute of Cosmetology"	"San Marcos, CA"
"Pamlico Community College"	"Grantsboro, NC"
"Panola College"	"Carthage, TX"
"Paradise Valley Community College"	"Phoenix, AZ"
"Paramount Beauty Academy"	"Portsmouth, OH"
"Paris Junior College"	"Paris, TX"
"Parisian Beauty School"	"Hackensack, NJ"
"Park University"	"Parkville, MO"
"Parker University"	"Dallas, TX"
"Paroba College"	"Everett, WA"
"Pasadena City College"	"Pasadena, CA"
"Pasco-Hernando State College"	"New Port Richey, FL"
"Passaic County Community College"	"Paterson, NJ"
"Patrick Henry Community College"	"Martinsville, VA"
"Paul D Camp Community College"	"Franklin, VA"
"Paul Mitchell The School Honolulu"	"Honolulu, HI"
"Paul Mitchell The School Indianapolis"	"Indianapolis, IN"
"Paul Mitchell the School Las Vegas"	"Las Vegas, NV"
"Paul Mitchell The School Raleigh"	"Raleigh, NC"
"Paul Mitchell The School Reno"	"Reno, NV"
"Paul Mitchell The School Spokane"	"Spokane Valley, WA"
"Paul Mitchell The School-Arlington"	"Arlington, TX"
"Paul Mitchell The School-Charleston"	"North Charleston, SC"
"Paul Mitchell The School-Columbia"	"Columbia, SC"
"Paul Mitchell the School-Denver"	"Lakewood, CO"
"Paul Mitchell the School-Fort Myers"	"Fort Myers, FL"
"Paul Mitchell the School-Jersey Shore"	"Brick, NJ"
"Paul Mitchell The School-Overland Park"	"Overland Park, KS"
"Paul Mitchell the School-Portland"	"Portland, OR"
"Paul Mitchell the School-Woodbridge"	"Woodbridge, VA"
"Paul Quinn College"	"Dallas, TX"
"Paul Smiths College of Arts and Science"	"Paul Smiths, NY"
"PCI College"	"Cerritos, CA"
"Pearl River Community College"	"Poplarville, MS"
"Peirce College"	"Philadelphia, PA"
"Pellissippi State Community College"	"Knoxville, TN"
"Peninsula College"	"Port Angeles, WA"
"Penn Commercial Business School"	"Washington, PA"
"Pennsylvania Academy of the Fine Arts"	"Philadelphia, PA"
"Pennsylvania College of Art and Design"	"Lancaster, PA"
"Pennsylvania College of Health Sciences"	"Lancaster, PA"
"Pennsylvania College of Technology"	"Williamsport, PA"
"Pennsylvania Highlands Community College"	"Johnstown, PA"
"Pennsylvania Institute of Health and Technology"	"Mount Braddock, PA"
"Pennsylvania Institute of Technology"	"Media, PA"
"Pennsylvania State University"	"State College, PA"
"Pennsylvania State University - World Campus"	"University Park, PA"
"Pennsylvania State University-Brandywine"	"Media, PA"
"Pennsylvania State University-College of Medicine"	"Hershey, PA"
"Pennsylvania State University-Dickinson Law"	"Carlisle, PA"
"Pennsylvania State University-Penn State Abington"	"Abington, PA"
"Pennsylvania State University-Penn State Altoona"	"Altoona, PA"
"Pennsylvania State University-Penn State Beaver"	"Monaca, PA"
"Pennsylvania State University-Penn State Berks"	"Reading, PA"
"Pennsylvania State University-Penn State Dubois"	"Dubois, PA"
"Pennsylvania State University-Penn State Erie-Behrend College"	"Erie, PA"
"Pennsylvania State University-Penn State Fayette- Eberly Campus"	"Uniontown, PA"
"Pennsylvania State University-Penn State Great Valley"	"Malvern, PA"
"Pennsylvania State University-Penn State Greater Allegheny"	"McKeesport, PA"
"Pennsylvania State University-Penn State Harrisburg"	"Middletown, PA"
"Pennsylvania State University-Penn State Hazleton"	"Hazleton, PA"
"Pennsylvania State University-Penn State Lehigh Valley"	"Center Valley, PA"
"Pennsylvania State University-Penn State Mont Alto"	"Mont Alto, PA"
"Pennsylvania State University-Penn State New Kensington"	"Upper Burrell, PA"
"Pennsylvania State University-Penn State Schuylkill"	"Schuylkill Haven, PA"
"Pennsylvania State University-Penn State Shenango"	"Sharon, PA"
"Pennsylvania State University-Penn State Wilkes-Barre"	"Lehman, PA"
"Pennsylvania State University-Penn State Worthington Scranton"	"Dunmore, PA"
"Pennsylvania State University-Penn State York"	"York, PA"
"PennWest California"	"California, PA"
"Penrose Academy"	"Scottsdale, AZ"
"Pensacola State College"	"Pensacola, FL"
"Penta County Joint Vocational School"	"Perrysburg, OH"
"Pentecostal Theological Seminary"	"Cleveland, TN"
"Perry Technical Institute"	"Yakima, WA"
"Peru State College"	"Peru, NE"
"Pfeiffer University"	"Misenheimer, NC"
"Philadelphia College of Osteopathic Medicine"	"Philadelphia, PA"
"Philadelphia University"	"Philadelphia, PA"
"Philander Smith College"	"Little Rock, AR"
"Phillips Beth Israel School of Nursing"	"New York, NY"
"Phillips Community College of the University of Arkansas"	"Helena, AR"
"Phoenix College"	"Phoenix, AZ"
"Phoenix Institute of Herbal Medicine & Acupuncture"	"Phoenix, AZ"
"Phoenix Seminary"	"Phoenix, AZ"
"Pickaway Ross Joint Vocational School District"	"Chillicothe, OH"
"Pickens Technical College"	"Aurora, CO"
"Piedmont College"	"Demorest, GA"
"Piedmont Community College"	"Roxboro, NC"
"Piedmont Virginia Community College"	"Charlottesville, VA"
"Pierce College at Puyallup"	"Puyallup, WA"
"Pierpont Community and Technical College"	"Fairmont, WV"
"Pike County Joint Vocational School District"	"Piketon, OH"
"Pima Community College"	"Tucson, AZ"
"Pine Manor College"	"Chestnut Hill, MA"
"Pine Technical College"	"Pine City, MN"
"Pinellas Technical College-Clearwater"	"Clearwater, FL"
"Pinellas Technical College-St Petersburg"	"St. Petersburg, FL"
"Pioneer Career and Technology Center"	"Shelby, OH"
"Pioneer Technology Center"	"Ponca City, OK"
"Pitt Community College"	"Winterville, NC"
"Pittsburgh Institute of Aeronautics"	"West Mifflin, PA"
"Pittsburgh Technical College"	"Oakdale, PA"
"Pitzer College"	"Claremont, CA"
"Platt College-Aurora"	"Aurora, CO"
"Platt College-Riverside"	"Riverside, CA"
"Plymouth State University"	"Plymouth, NH"
"Point Loma Nazarene University"	"San Diego, CA"
"Point Park University"	"Pittsburgh, PA"
"Polaris Career Center"	"Middleburg Heights, OH"
"Polk State College"	"Winter Haven, FL"
"Polytechnic University of Puerto Rico-Miami Campus"	"Miami, FL"
"Polytechnic University of Puerto Rico-Orlando Campus"	"Winter Park, FL"
"Pomeroy College of Nursing at Crouse Hospital"	"Syracuse, NY"
"Pomona College"	"Claremont, CA"
"Pomona Unified School District Adult and Career Education"	"Pomona, CA"
"Pontifical College Josephinum"	"Columbus, OH"
"Pontotoc Technology Center"	"Ada, OK"
"Porterville College"	"Porterville, CA"
"Portland Community College"	"Portland, OR"
"Portland State University"	"Portland, OR"
"Post University"	"Waterbury, CT"
"Potomac State College of West Virginia University"	"Keyser, WV"
"Prairie State College"	"Chicago Heights, IL"
"Prairie View A & M University"	"Prairie View, TX"
"Pratt Community College"	"Pratt, KS"
"Pratt Institute-Main"	"Brooklyn, NY"
"Praxis Institute"	"Miami, FL"
"Premiere Career College"	"Irwindale, CA"
"Presbyterian College"	"Clinton, SC"
"Prescott College"	"Prescott, AZ"
"Presentation College"	"Aberdeen, SD"
"Prestige Health & Beauty Sciences Academy"	"North Miami Beach, FL"
"Prince George's Community College"	"Largo, MD"
"Princeton Information Technology Center"	"Glenside, PA"
"Princeton University"	"Princeton, NJ"
"Principia College"	"Elsah, IL"
"Professional Career Training Institute"	"Houston, TX"
"Professional Golfers Career College"	"Temecula, CA"
"Professional Institute of Beauty"	"El Monte, CA"
"Professional Skills Institute"	"Toledo, OH"
"Providence College"	"Providence, RI"
"Purdue University Fort Wayne"	"Fort Wayne, IN"
"Purdue University Northwest"	"Hammond, IN"
"Putnam Career and Technical Center"	"Eleanor, WV"
"Queen City College"	"Clarksville, TN"
"Quincy College"	"Quincy, MA"
"Quincy University"	"Quincy, IL"
"Quinebaug Valley Community College"	"Danielson, CT"
"Quinnipiac University"	"Hamden, CT"
"Quinsigamond Community College"	"Worcester, MA"
"Radford M Locklin Technical Center"	"Milton, FL"
"Rainy River Community College"	"International Falls, MN"
"Randall University"	"Moore, OK"
"Randolph College"	"Lynchburg, VA"
"Randolph Community College"	"Asheboro, NC"
"Randolph-Macon College"	"Ashland, VA"
"Ranger College"	"Ranger, TX"
"Ranken Technical College"	"St. Louis, MO"
"Rappahannock Community College"	"Glenns, VA"
"Raritan Valley Community College"	"Branchburg, NJ"
"Ravenscroft Beauty College"	"Fort Wayne, IN"
"Razzle Dazzle College Inc"	"Nampa, ID"
"Reading Area Community College"	"Reading, PA"
"The Reading Hospital School of Health Sciences"	"Reading, PA"
"Red River Technology Center"	"Duncan, OK"
"Red Rocks Community College"	"Lakewood, CO"
"Redlands Community College"	"El Reno, OK"
"Reed College"	"Portland, OR"
"Reedley College"	"Reedley, CA"
"Refrigeration School"	"Phoenix, AZ"
"Reid State Technical College"	"Evergreen, AL"
"Reinhardt University"	"Waleska, GA"
"Rend Lake College"	"Ina, IL"
"Rensselaer Hartford Graduate Center Inc"	"Hartford, CT"
"Rensselaer Polytechnic Institute"	"Troy, NY"
"Renton Technical College"	"Renton, WA"
"Research College of Nursing"	"Kansas City, MO"
"The Restaurant School at Walnut Hill College"	"Philadelphia, PA"
"Resurrection University"	"Oak Park, IL"
"Reynolds Community College"	"Richmond, VA"
"Rhode Island College"	"Providence, RI"
"Rhode Island School of Design"	"Providence, RI"
"Rhodes College"	"Memphis, TN"
"Rice University"	"Houston, TX"
"Rich Mountain Community College"	"Mena, AR"
"Richard Bland College of the College of William and Mary"	"Petersburg, VA"
"Richland College"	"Dallas, TX"
"Richland Community College"	"Decatur, IL"
"Richmond Community College"	"Hamlet, NC"
"Richmond School of Health and Technology"	"Richmond, VA"
"Richmont Graduate University"	"Chattanooga, TN"
"Ridge Career Center"	"Winter Haven, FL"
"Ringling College of Art and Design"	"Sarasota, FL"
"Rio Hondo College"	"Whittier, CA"
"Rio Salado College"	"Tempe, AZ"
"Ripon College"	"Ripon, WI"
"River Parishes Community College"	"Sorrento, LA"
"River Valley Community College"	"Claremont, NH"
"Riverland Community College"	"Austin, MN"
"Riverside City College"	"Riverside, CA"
"Riverside School of Health Careers"	"Newport News, VA"
"Rivertown School of Beauty Barber Skin Care and Nails"	"Columbus, GA"
"Rivier University"	"Nashua, NH"
"Rizzieri Aveda School for Beauty and Wellness"	"Voorhees, NJ"
"Roanoke College"	"Salem, VA"
"Roanoke-Chowan Community College"	"Ahoskie, NC"
"Robert Morgan Educational Center"	"Miami, FL"
"Robert Morris University"	"Moon, PA"
"Robert Morris University Illinois"	"Chicago, IL"
"Roberts Wesleyan College"	"Rochester, NY"
"Robeson Community College"	"Lumberton, NC"
"Rochester Community and Technical College"	"Rochester, MN"
"Rochester Institute of Technology"	"Rochester, NY"
"Rochester University"	"Rochester Hills, MI"
"Rock Valley College"	"Rockford, IL"
"Rockefeller University"	"New York, NY"
"Rockford University"	"Rockford, IL"
"Rockingham Community College"	"Wentworth, NC"
"Rockland Community College"	"Suffern, NY"
"Rockland County BOCES-Practical Nursing Program"	"West Nyack, NY"
"Rocky Mountain College"	"Billings, MT"
"Rocky Mountain University of Health Professions"	"Provo, UT"
"Rocky Vista University"	"Parker, CO"
"Roger Williams University"	"Bristol, RI"
"Roger Williams University School of Law"	"Bristol, RI"
"Rogers State University"	"Claremore, OK"
"Rogue Community College"	"Grants Pass, OR"
"Rolla Technical Institute"	"Rolla, MO"
"Rollins College"	"Winter Park, FL"
"Roosevelt University"	"Chicago, IL"
"Rosalind Franklin University of Medicine and Science"	"North Chicago, IL"
"Rose State College"	"Midwest City, OK"
"Rose-Hulman Institute of Technology"	"Terre Haute, IN"
"Rosedale Technical College"	"Pittsburgh, PA"
"Roseman University"	"Henderson, NV"
"Rosemead Beauty School"	"Rosemead, CA"
"Rosemont College"	"Rosemont, PA"
"Ross College"	"Sylvania, OH"
"Ross Institute of Medical and Dental Technology"	"Cincinnati, OH"
"Ross Medical Education Center-Charleston"	"Charleston, WV"
"Ross Medical Education Center-Erlanger"	"Erlanger, KY"
"Ross Medical Education Center-Kokomo"	"Kokomo, IN"
"Rowan College at Burlington County"	"Pemberton, NJ"
"Rowan College of South Jersey"	"Sewell, NJ"
"Rowan University"	"Glassboro, NJ"
"Rowan-Cabarrus Community College"	"Salisbury, NC"
"Roxborough Memorial Hospital School of Nursing"	"Philadelphia, PA"
"Roxbury Community College"	"Roxbury Crossing, MA"
"Rudy & Kelly Academy of Hair and Nails"	"Virginia Beach, VA"
"Rush University"	"Chicago, IL"
"Rust College"	"Holly Springs, MS"
"Rutgers University"	"New Brunswick, NJ"
"Rutgers University - Bloustein School"	"New Brunswick, NJ"
"Rutgers University - Camden"	"Camden, NJ"
"Rutgers University-Newark"	"Newark, NJ"
"Saber"	"Miami, FL"
"Sacramento City College"	"Sacramento, CA"
"Saddleback College"	"Mission Viejo, CA"
"The Sage Colleges"	"Troy, NY"
"Saginaw Chippewa Tribal College"	"Mount Pleasant, MI"
"Saginaw Valley State University"	"University Center, MI"
"Saint Ambrose University"	"Davenport, IA"
"Saint Anselm College"	"Manchester, NH"
"Saint Anthony College of Nursing"	"Rockford, IL"
"Saint Augustine College"	"Chicago, IL"
"Saint Cloud State University"	"St. Cloud, MN"
"Saint Edward's University"	"Austin, TX"
"Saint Elizabeth School of Nursing"	"Lafayette, IN"
"Saint Francis Medical Center College of Nursing"	"Peoria, IL"
"Saint John's University - MN"	"Collegeville, MN"
"Saint Joseph's College - New York"	"Brooklyn, NY"
"Saint Leo University"	"St. Leo, FL"
"Saint Louis Community College"	"St. Louis, MO"
"Saint Louis University-Main Campus"	"St. Louis, MO"
"Saint Luke's College of Health Sciences"	"Kansas City, MO"
"Saint Martin's University"	"Lacey, WA"
"Saint Mary-of-the-Woods College"	"Saint Mary of the Woods, IN"
"Saint Mary's College - IN"	"Notre Dame, IN"
"Saint Mary's College of California"	"Moraga, CA"
"Saint Meinrad Seminary and School of Theology"	"Saint Meinrad, IN"
"Saint Michael's College"	"Colchester, VT"
"Saint Norbert College"	"De Pere, WI"
"Saint Paul College"	"Saint Paul, MN"
"Saint Thomas Aquinas College"	"Sparkill, NY"
"Saint Vincent College"	"Latrobe, PA"
"Salem College"	"Winston Salem, NC"
"Salem Community College"	"Carneys Point, NJ"
"Salem State University"	"Salem, MA"
"Salem University"	"Salem, WV"
"Salina Area Technical College"	"Salina, KS"
"Salisbury University"	"Salisbury, MD"
"Salish Kootenai College"	"Pablo, MT"
"Salon Professional Academy of Kenosha (The)"	"Kenosha, WI"
"The Salon Professional Academy-Huntsville"	"Huntsville, AL"
"The Salon Professional Academy-South Plainfield"	"South Plainfield, NJ"
"Salt Lake Community College"	"Salt Lake City, UT"
"The Salter School"	"New Bedford, MA"
"Salus University"	"Elkins Park, PA"
"Salve Regina University"	"Newport, RI"
"Sam Houston State University"	"Huntsville, TX"
"Samaritan Hospital School of Nursing"	"Troy, NY"
"Samford University"	"Birmingham, AL"
"Sampson Community College"	"Clinton, NC"
"Samuel Merritt University"	"Oakland, CA"
"San Antonio College"	"San Antonio, TX"
"San Bernardino Valley College"	"San Bernardino, CA"
"San Diego City College"	"San Diego, CA"
"San Diego Culinary Institute"	"San Diego, CA"
"San Diego Mesa College"	"San Diego, CA"
"San Diego Miramar College"	"San Diego, CA"
"San Diego State University"	"San Diego, CA"
"San Francisco Art Institute"	"San Francisco, CA"
"San Francisco Institute of Esthetics and Cosmetology"	"San Francisco, CA"
"San Francisco State University"	"San Francisco, CA"
"San Francisco Theological Seminary"	"San Anselmo, CA"
"San Jacinto Community College"	"Pasadena, TX"
"San Joaquin College of Law"	"Clovis, CA"
"San Jose City College"	"San Jose, CA"
"San Jose State University"	"San Jose, CA"
"San Juan College"	"Farmington, NM"
"Sandhills Community College"	"Pinehurst, NC"
"Santa Ana Beauty College"	"Santa Ana, CA"
"Santa Ana College"	"Santa Ana, CA"
"Santa Barbara City College"	"Santa Barbara, CA"
"Santa Clara University"	"Santa Clara, CA"
"Santa Fe College"	"Gainesville, FL"
"Santa Fe Community College"	"Santa Fe, NM"
"Santa Monica College"	"Santa Monica, CA"
"Santiago Canyon College"	"Orange, CA"
"Sarah Lawrence College"	"Bronxville, NY"
"Sarasota County Technical Institute"	"Sarasota, FL"
"Sauk Valley Community College"	"Dixon, IL"
"Savannah College of Art and Design"	"Savannah, GA"
"Savannah State University"	"Savannah, GA"
"Saybrook University Hybrid Online"	"Oakland, CA"
"Schenectady County Community College"	"Schenectady, NY"
"Schiller International University"	"Largo, FL"
"Schilling-Douglas School of Hair Design"	"Newark, DE"
"School for International Training"	"Brattleboro, VT"
"School of Automotive Machinists"	"Houston, TX"
"School of Missionary Aviation Technology"	"Ionia, MI"
"School of the Art Institute of Chicago"	"Chicago, IL"
"School of Visual Arts"	"New York, NY"
"Schoolcraft College"	"Livonia, MI"
"Schreiner University"	"Kerrville, TX"
"Schuyler-Steuben-Chemung-Tioga-Allegany BOCES"	"Hornell, NY"
"Schuylkill Technology Center"	"Frackville, PA"
"Scioto County Career Technical Center"	"Lucasville, OH"
"Scottsdale Community College"	"Scottsdale, AZ"
"Scripps College"	"Claremont, CA"
"Searcy Beauty College Inc"	"Searcy, AR"
"Seattle Central College"	"Seattle, WA"
"Seattle Pacific University"	"Seattle, WA"
"The Seattle School of Theology & Psychology"	"Seattle, WA"
"Seattle University"	"Seattle, WA"
"Selma University"	"Selma, AL"
"Seminar L'moros Bais Yaakov"	"Brooklyn, NY"
"Seminole State College"	"Seminole, OK"
"Sentara College of Health Sciences"	"Chesapeake, VA"
"Seton Hill University"	"Greensburg, PA"
"Sewanee-The University of the South"	"Sewanee, TN"
"Seward County Community College"	"Liberal, KS"
"Shasta College"	"Redding, CA"
"Shaw University"	"Raleigh, NC"
"Shawnee Community College"	"Ullin, IL"
"Shawnee State University"	"Portsmouth, OH"
"Shear Ego International School of Hair Design"	"Rochester, NY"
"Shear Finesse Hairstyling Academy"	"Jacksonville, FL"
"Shelton State Community College"	"Tuscaloosa, AL"
"Shenandoah University"	"Winchester, VA"
"Shepherds College"	"Union Grove, WI"
"Sheridan College"	"Sheridan, WY"
"Sheridan Technical College"	"Hollywood, FL"
"Sherman College of Chiropractic"	"Spartanburg, SC"
"Shippensburg University of Pennsylvania"	"Shippensburg, PA"
"Shoreline Community College"	"Shoreline, WA"
"Shorter University"	"Rome, GA"
"Siena College"	"Loudonville, NY"
"Sierra College of Beauty"	"Merced, CA"
"Sierra Nevada College"	"Incline Village, NV"
"Signature Healthcare Brockton Hospital School of Nursing"	"Brockton, MA"
"Silver Lake College"	"Manitowoc, WI"
"Simmons College of Kentucky"	"Louisville, KY"
"Simpson College"	"Indianola, IA"
"Simpson University"	"Redding, CA"
"Sinclair Community College"	"Dayton, OH"
"Sinte Gleska University"	"Mission, SD"
"Sisseton Wahpeton College"	"Sisseton, SD"
"Sitting Bull College"	"Fort Yates, ND"
"Skagit Valley College"	"Mount Vernon, WA"
"Skidmore College"	"Saratoga Springs, NY"
"Skyline College - CA"	"San Bruno, CA"
"Slippery Rock University of Pennsylvania"	"Slippery Rock, PA"
"Smith College"	"Northampton, MA"
"Snead State Community College"	"Boaz, AL"
"Snow College"	"Ephraim, UT"
"Sofia University"	"Palo Alto, CA"
"Somerset Christian College"	"Zarephath, NJ"
"Somerset Community College"	"Somerset, KY"
"Sonoma State University"	"Rohnert Park, CA"
"Sonoran Desert Institute"	"Scottsdale, AZ"
"South Arkansas Community College"	"El Dorado, AR"
"South Baylo University"	"Anaheim, CA"
"South Carolina State University"	"Orangeburg, SC"
"South Central College"	"North Mankato, MN"
"South College - Asheville"	"Asheville, NC"
"South Dakota School of Mines and Technology"	"Rapid City, SD"
"South Dakota State University"	"Brookings, SD"
"South Florida Institute of Technology"	"Miami, FL"
"South Georgia State College"	"Douglas, GA"
"South Hills School of Business & Technology"	"State College, PA"
"South Louisiana Community College"	"Lafayette, LA"
"South Mountain Community College"	"Phoenix, AZ"
"South Piedmont Community College"	"Polkton, NC"
"South Plains College"	"Levelland, TX"
"South Puget Sound Community College"	"Olympia, WA"
"South Seattle College"	"Seattle, WA"
"South Suburban College"	"South Holland, IL"
"South Texas College of Law Houston"	"Houston, TX"
"South University-Austin"	"Austin, TX"
"South University-High Point"	"High Point, NC"
"Southcentral Kentucky Community and Technical College"	"Bowling Green, KY"
"Southeast Arkansas College"	"Pine Bluff, AR"
"Southeast Kentucky Community and Technical College"	"Cumberland, KY"
"Southeast Missouri Hospital College of Nursing and Health Sciences"	"Cape Girardeau, MO"
"Southeast Missouri State University"	"Cape Girardeau, MO"
"Southeast Technical Institute"	"Sioux Falls, SD"
"Southeast Texas Career Institute"	"Silsbee, TX"
"Southeastern Baptist Theological Seminary"	"Wake Forest, NC"
"Southeastern Community College - IA"	"West Burlington, IA"
"Southeastern Community College - NC"	"Whiteville, NC"
"Southeastern Illinois College"	"Harrisburg, IL"
"Southeastern Louisiana University"	"Hammond, LA"
"Southeastern Technical Institute"	"South Easton, MA"
"Southeastern University"	"Lakeland, FL"
"Southern Adventist University"	"Collegedale, TN"
"Southern Arkansas University"	"Magnolia, AR"
"Southern Arkansas University Tech"	"Camden, AR"
"The Southern Baptist Theological Seminary"	"Louisville, KY"
"Southern California Health Institute"	"North Hollywood, CA"
"Southern California Institute of Technology"	"Anaheim, CA"
"Southern California Seminary"	"El Cajon, CA"
"Southern California University of Health Sciences"	"Whittier, CA"
"Southern Careers Institute-San Antonio"	"San Antonio, TX"
"Southern Connecticut State University"	"New Haven, CT"
"Southern Illinois University - Carbondale"	"Carbondale, IL"
"Southern Maine Community College"	"South Portland, ME"
"Southern Nazarene University"	"Bethany, OK"
"Southern Oklahoma Technology Center"	"Ardmore, OK"
"Southern Texas Careers Academy"	"McAllen, TX"
"Southern University and A & M College"	"Baton Rouge, LA"
"Southern University at New Orleans"	"New Orleans, LA"
"Southern University at Shreveport"	"Shreveport, LA"
"Southern University Law Center"	"Baton Rouge, LA"
"Southern Virginia University"	"Buena Vista, VA"
"Southern West Virginia Community and Technical College"	"Mount Gay, WV"
"Southern Westchester BOCES-Practical Nursing Program"	"Elmsford, NY"
"Southside Regional Medical Center Professional Schools"	"Petersburg, VA"
"Southside Virginia Community College"	"Alberta, VA"
"Southwest Applied Technology Center"	"Cedar City, UT"
"Southwest Baptist University"	"Bolivar, MO"
"Southwest Career College"	"El Paso, TX"
"Southwest College of Naturopathic Medicine & Health Sciences"	"Tempe, AZ"
"Southwest Collegiate Institute for the Deaf"	"Big Spring, TX"
"Southwest Institute of Healing Arts"	"Tempe, AZ"
"Southwest Minnesota State University"	"Marshall, MN"
"Southwest Mississippi Community College"	"Summit, MS"
"Southwest Texas Junior College"	"Uvalde, TX"
"Southwest Virginia Community College"	"Richlands, VA"
"Southwest Wisconsin Technical College"	"Fennimore, WI"
"Southwestern Adventist University"	"Keene, TX"
"Southwestern Assemblies of God University"	"Waxahachie, TX"
"Southwestern Christian University"	"Bethany, OK"
"Southwestern College - CA"	"Chula Vista, CA"
"Southwestern College - KS"	"Winfield, KS"
"Southwestern College - NM"	"Santa Fe, NM"
"Southwestern Community College - IA"	"Creston, IA"
"Southwestern Community College - NC"	"Sylva, NC"
"Southwestern Indian Polytechnic Institute"	"Albuquerque, NM"
"Southwestern Law School"	"Los Angeles, CA"
"Southwestern Michigan College"	"Dowagiac, MI"
"Southwestern Oklahoma State University"	"Weatherford, OK"
"Southwestern University"	"Georgetown, TX"
"Sowela Technical Community College"	"Lake Charles, LA"
"Spartanburg Community College"	"Spartanburg, SC"
"Spartanburg Methodist College"	"Spartanburg, SC"
"Specs Howard School of Media Arts"	"Southfield, MI"
"Spelman College"	"Atlanta, GA"
"Spertus College"	"Chicago, IL"
"Spokane Community College"	"Spokane, WA"
"Spokane Falls Community College"	"Spokane, WA"
"Spoon River College"	"Canton, IL"
"Springfield College"	"Springfield, MA"
"Springfield College-School of Human Services"	"Springfield, MA"
"Springfield Technical Community College"	"Springfield, MA"
"St Charles Community College"	"Cottleville, MO"
"St Clair County Community College"	"Port Huron, MI"
"St Cloud Technical and Community College"	"St. Cloud, MN"
"St Lawrence University"	"Canton, NY"
"St Louis College of Pharmacy"	"St. Louis, MO"
"St Margaret School of Nursing"	"Pittsburgh, PA"
"St Mary's College of Maryland"	"St. Mary's City, MD"
"St Olaf College"	"Northfield, MN"
"St Philip's College"	"San Antonio, TX"
"St. Augustine's University"	"Raleigh, NC"
"St. Catherine University"	"Saint Paul, MN"
"St. Francis College"	"Brooklyn Heights, NY"
"St. John Fisher College"	"Rochester, NY"
"St. John's College of Nursing - IL"	"Springfield, IL"
"St. Joseph School of Nursing - NH"	"Nashua, NH"
"St. Joseph's College of Nursing at St. Joseph's Hospital Health Center"	"Syracuse, NY"
"St. Luke's College"	"Sioux City, IA"
"St. Mary's University"	"San Antonio, TX"
"St. Peter's University"	"Jersey City, NJ"
"St. Petersburg College"	"Clearwater, FL"
"St. Vincent's College"	"Bridgeport, CT"
"Stage One-The Hair School"	"Lake Charles, LA"
"Standard Beauty College of Oklahoma LLC"	"Sand Springs, OK"
"Stanford University"	"Stanford, CA"
"Stanly Community College"	"Albemarle, NC"
"Star College of Cosmetology 2"	"Tyler, TX"
"Stark State College"	"North Canton, OH"
"State Fair Community College"	"Sedalia, MO"
"State Technical College of Missouri"	"Linn, MO"
"Stephen F. Austin State University"	"Nacogdoches, TX"
"Stephens College"	"Columbia, MO"
"Sterling College - KS"	"Sterling, KS"
"Stetson University"	"Deland, FL"
"Stevens Institute of Business & Arts"	"St. Louis, MO"
"Stevens Institute of Technology"	"Hoboken, NJ"
"Stevenson University"	"Stevenson, MD"
"Stevensons Academy of Hair Design"	"New Orleans, LA"
"Stewart School"	"Sioux Falls, SD"
"Stillman College"	"Tuscaloosa, AL"
"Stone Child College"	"Box Elder, MT"
"Stonehill College"	"Easton, MA"
"Stony Brook University"	"Stony Brook, NY"
"Studio Academy of Beauty"	"Chandler, AZ"
"Stylemaster College of Hair Design"	"Longview, WA"
"Success Schools LLC"	"Merrillville, IN"
"Suffolk County Community College"	"Selden, NY"
"Suffolk University"	"Boston, MA"
"Sul Ross State University"	"Alpine, TX"
"Sullivan and Cogliano Training Center"	"Brockton, MA"
"Sullivan College of Technology and Design"	"Louisville, KY"
"Sullivan County Community College"	"Loch Sheldrake, NY"
"Summit Academy Opportunities Industrialization Center"	"Minneapolis, MN"
"Sumner College"	"Portland, OR"
"SUNY at Albany"	"Albany, NY"
"SUNY College at Cortland"	"Cortland, NY"
"SUNY College at Oswego"	"Oswego, NY"
"SUNY College of Technology at Canton"	"Canton, NY"
"SUNY College of Technology at Delhi"	"Delhi, NY"
"SUNY Corning Community College"	"Corning, NY"
"SUNY Morrisville"	"Morrisville, NY"
"Surry Community College"	"Dobson, NC"
"Susquehanna University"	"Selinsgrove, PA"
"Sussex County Community College"	"Newton, NJ"
"Suwannee-Hamilton Technical Center"	"Live Oak, FL"
"Swarthmore College"	"Swarthmore, PA"
"Swedish Institute"	"New York, NY"
"Sweet Briar College"	"Sweet Briar, VA"
"System - A Paul Mitchell Partner School"	"Springfield, MO"
"Tabor College"	"Hillsboro, KS"
"Tacoma Community College"	"Tacoma, WA"
"Taft College"	"Taft, CA"
"Taft University System"	"Santa Ana, CA"
"Talladega College"	"Talladega, AL"
"Tallahassee Community College"	"Tallahassee, FL"
"Tarleton State University"	"Stephenville, TX"
"Tarrant County College District"	"Fort Worth, TX"
"Taylor Andrews Academy-St. George"	"St. George, UT"
"Taylor College"	"Belleview, FL"
"Taylor Technical Institute"	"Perry, FL"
"Taylor University"	"Upland, IN"
"Taylortown School of Beauty Inc"	"Taylor, MI"
"TCTC Adult Training Center"	"Warren, OH"
"TDDS Technical Institute"	"Lake Milton, OH"
"Teachers College at Columbia University"	"New York, NY"
"Technical College of the Lowcountry"	"Beaufort, SC"
"Technical Education Center-Osceola"	"Kissimmee, FL"
"Technical Learning Centers Inc"	"Washington D.C., DC"
"Temple College"	"Temple, TX"
"Temple University"	"Philadelphia, PA"
"The Temple-A Paul Mitchell Partner School"	"Frederick, MD"
"Tennessee College of Applied Technology - Athens"	"Athens, TN"
"Tennessee College of Applied Technology - Covington"	"Covington, TN"
"Tennessee College of Applied Technology - Crossville"	"Crossville, TN"
"Tennessee College of Applied Technology - Crump"	"Crump, TN"
"Tennessee College of Applied Technology - Dickson"	"Dickson, TN"
"Tennessee College of Applied Technology - Elizabethton"	"Elizabethton, TN"
"Tennessee College of Applied Technology - Harriman"	"Harriman, TN"
"Tennessee College of Applied Technology - Hartsville"	"Hartsville, TN"
"Tennessee College of Applied Technology - Hohenwald"	"Hohenwald, TN"
"Tennessee College of Applied Technology - Jacksboro"	"Jacksboro, TN"
"Tennessee College of Applied Technology - Jackson"	"Jackson, TN"
"Tennessee College of Applied Technology - Knoxville"	"Knoxville, TN"
"Tennessee College of Applied Technology - Livingston"	"Livingston, TN"
"Tennessee College of Applied Technology - McKenzie"	"McKenzie, TN"
"Tennessee College of Applied Technology - McMinnville"	"McMinnville, TN"
"Tennessee College of Applied Technology - Memphis"	"Memphis, TN"
"Tennessee College of Applied Technology - Morristown"	"Morristown, TN"
"Tennessee College of Applied Technology - Murfreesboro"	"Murfreesboro, TN"
"Tennessee College of Applied Technology - Nashville"	"Nashville, TN"
"Tennessee College of Applied Technology - Newbern"	"Newbern, TN"
"Tennessee College of Applied Technology - Oneida-Huntsville"	"Huntsville, TN"
"Tennessee College of Applied Technology - Paris"	"Paris, TN"
"Tennessee College of Applied Technology - Pulaski"	"Pulaski, TN"
"Tennessee College of Applied Technology - Ripley"	"Ripley, TN"
"Tennessee College of Applied Technology - Shelbyville"	"Shelbyville, TN"
"Tennessee College of Applied Technology - Whiteville"	"Whiteville, TN"
"Tennessee School of Beauty of Knoxville Inc"	"Knoxville, TN"
"Tennessee State University"	"Nashville, TN"
"Tennessee Tech University"	"Cookeville, TN"
"Tennessee Wesleyan University"	"Athens, TN"
"Terra State Community College"	"Fremont, OH"
"Teterboro School of Aeronautics"	"Teterboro, NJ"
"Texarkana College"	"Texarkana, TX"
"Texas A&M University - College Station"	"College Station, TX"
"Texas A&M University - Commerce"	"Commerce, TX"
"Texas A&M University - Kingsville"	"Kingsville, TX"
"Texas A&M University - Texarkana"	"Texarkana, TX"
"Texas A&M University-Central Texas"	"Killeen, TX"
"Texas A&M University-San Antonio"	"One University Way, TX"
"Texas Beauty College"	"Haltom City, TX"
"Texas Chiropractic College Foundation Inc"	"Pasadena, TX"
"Texas Christian University"	"Fort Worth, TX"
"Texas College"	"Tyler, TX"
"Texas County Technical Institute"	"Houston, MO"
"Texas Health and Science University"	"Austin, TX"
"Texas Health School"	"Houston, TX"
"Texas Lutheran University"	"Seguin, TX"
"Texas Southern University"	"Houston, TX"
"Texas State University"	"San Marcos, TX"
"Texas Tech University"	"Lubbock, TX"
"Texas Tech University Health Sciences Center"	"Lubbock, TX"
"Texas Wesleyan University"	"Fort Worth, TX"
"Thaddeus Stevens College of Technology"	"Lancaster, PA"
"Thiel College"	"Greenville, PA"
"Thomas College"	"Waterville, ME"
"Thomas Edison State University"	"Trenton, NJ"
"Thomas Jefferson University"	"Philadelphia, PA"
"Thomas Nelson Community College"	"Hampton, VA"
"Thomas University"	"Thomasville, GA"
"Three Rivers Community College - CT"	"Norwich, CT"
"Three Rivers Community College - MO"	"Poplar Bluff, MO"
"Thunderbird School of Global Management"	"Glendale, AZ"
"Tidewater Community College"	"Norfolk, VA"
"Tidewater Tech-Trades"	"Norfolk, VA"
"Tiffin University"	"Tiffin, OH"
"Tillamook Bay Community College"	"Tillamook, OR"
"Toccoa Falls College"	"Toccoa Falls, GA"
"Tohono O'Odham Community College"	"Sells, AZ"
"Toledo Public Schools Adult & Continuing Education"	"Toledo, OH"
"Tom P Haney Technical Center"	"Panama City, FL"
"Tompkins Cortland Community College"	"Dryden, NY"
"Tooele Applied Technology College"	"Tooele, UT"
"Top Nails & Hair Beauty School"	"UT 84118-0000, UT"
"Total Image Beauty Academy"	"Union City, NJ"
"Tougaloo College"	"Tougaloo, MS"
"Touro College"	"New York, NY"
"Touro University California"	"Vallejo, CA"
"Touro University Nevada"	"Henderson, NV"
"Towson University"	"Towson, MD"
"Transformed Barber and Cosmetology Academy"	"Kansas City, MO"
"Transylvania University"	"Lexington, KY"
"Traviss Career Center"	"Lakeland, FL"
"Treasure Valley Community College"	"Ontario, OR"
"Trend Setters College of Cosmetology"	"Bradley, IL"
"Trend Setters' Academy of Beauty Culture"	"Louisville, KY"
"Trenz Beauty Academy"	"IL 60409, IL"
"Tri-County Adult Career Center"	"Nelsonville, OH"
"Tri-County Community College"	"Murphy, NC"
"Tri-County Technical College"	"Pendleton, SC"
"Tri-Rivers Career Center"	"Marion, OH"
"Tri-State Cosmetology Institute 1"	"El Paso, TX"
"Tribeca Flashpoint College"	"Chicago, IL"
"Trine University Online"	"Fort Wayne, IN"
"Trinity Baptist College"	"Jacksonville, FL"
"Trinity Bible College"	"Ellendale, ND"
"Trinity Christian College"	"Palos Heights, IL"
"Trinity College"	"Hartford, CT"
"Trinity College of Florida"	"Trinity, FL"
"Trinity College of Nursing and Health Sciences"	"Rock Island, IL"
"Trinity International University - Illinois"	"Deerfield, IL"
"Trinity International University-Florida"	"Davie, FL"
"Trinity Law School"	"Santa Ana, CA"
"Trinity University"	"San Antonio, TX"
"Trinity Valley Community College"	"Athens, TX"
"Trinity Vocational Center"	"Gardena, CA"
"Trinity Washington University"	"Washington D.C., DC"
"Triton College"	"River Grove, IL"
"Trocaire College"	"Buffalo, NY"
"Troy University"	"Troy, AL"
"Truckee Meadows Community College"	"Reno, NV"
"Truett McConnell University"	"Cleveland, GA"
"Truman State University"	"Kirksville, MO"
"Tucson College"	"Tucson, AZ"
"Tufts University"	"Medford, MA"
"Tulsa Community College"	"Tulsa, OK"
"Tunxis Community College"	"Farmington, CT"
"Turtle Mountain Community College"	"Belcourt, ND"
"Tusculum University"	"Greeneville, TN"
"Tuskegee University"	"Tuskegee, AL"
"Twin City Beauty College"	"St. Joseph, MI"
"Tyler Junior College"	"Tyler, TX"
"UEI College-Fresno"	"Fresno, CA"
"Uintah Basin Applied Technology College"	"Roosevelt, UT"
"Ukiah Adult School"	"Ukiah, CA"
"Ulster County BOCES-School of Practical Nursing"	"Port Ewen, NY"
"Ulster County Community College"	"Stone Ridge, NY"
"Umpqua Community College"	"Roseburg, OR"
"Union College - KY"	"Barbourville, KY"
"Union College - NE"	"Lincoln, NE"
"Union College - NY"	"Schenectady, NY"
"Union County College"	"Cranford, NJ"
"Union County Vocational Technical School"	"Scotch Plains, NJ"
"Union Institute & University"	"Cincinnati, OH"
"Union University"	"Jackson, TN"
"United States Air Force Academy"	"USAFA, CO"
"United States Coast Guard Academy"	"New London, CT"
"United States Military Academy"	"West  Point, NY"
"United States Naval Academy"	"Annapolis, MD"
"United States Sports Academy"	"Daphne, AL"
"United Tribes Technical College"	"Bismarck, ND"
"Unitek College"	"Fremont, CA"
"Unity College"	"Unity, ME"
"Universal Training Institute"	"Perth Amboy, NJ"
"University at Buffalo"	"Buffalo, NY"
"University of Akron"	"Akron, OH"
"University of Akron Wayne College"	"Orrville, OH"
"University of Alabama"	"Tuscaloosa, AL"
"University of Alaska Anchorage"	"Anchorage, AK"
"University of Alaska Southeast"	"Juneau, AK"
"University of Antelope Valley"	"Lancaster, CA"
"University of Arizona"	"Tucson, AZ"
"University of Arizona - Engineering"	"Tucson, AZ"
"University of Arkansas"	"Fayetteville, AR"
"University of Arkansas - Fort Smith"	"Fort Smith, AR"
"University of Arkansas at Little Rock"	"Little Rock, AR"
"University of Arkansas at Pine Bluff"	"Pine Bluff, AR"
"University of Arkansas Community College-Batesville"	"Batesville, AR"
"University of Arkansas Community College-Hope"	"Hope, AR"
"University of Arkansas Community College-Morrilton"	"Morrilton, AR"
"University of Arkansas for Medical Sciences"	"Little Rock, AR"
"University of Baltimore"	"Baltimore, MD"
"University of Bridgeport"	"Bridgeport, CT"
"University of California - Berkeley"	"Berkeley, CA"
"University of California - Los Angeles"	"Los Angeles, CA"
"University of California Hastings College of Law"	"San Francisco, CA"
"University of California-Davis"	"Davis, CA"
"University of California-Irvine"	"Irvine, CA"
"University of California-Merced"	"Merced, CA"
"University of California-Riverside"	"Riverside, CA"
"University of California-San Diego"	"La Jolla, CA"
"University of California-San Francisco"	"San Francisco, CA"
"University of California-Santa Barbara"	"Santa Barbara, CA"
"University of California-Santa Cruz"	"Santa Cruz, CA"
"University of Central Arkansas"	"Conway, AR"
"University of Central Missouri"	"Warrensburg, MO"
"University of Central Oklahoma"	"Edmond, OK"
"University of Charleston"	"Charleston, WV"
"University of Chicago"	"Chicago, IL"
"University of Cincinnati-Clermont College"	"Batavia, OH"
"University of Cincinnati-UC Blue Ash College"	"Blue Ash, OH"
"University of Colorado Boulder"	"Boulder, CO"
"University of Colorado Colorado Springs"	"Colorado Springs, CO"
"University of Connecticut"	"Storrs, CT"
"University of Dallas"	"Irving, TX"
"University of Detroit Mercy"	"Detroit, MI"
"University of Dubuque"	"Dubuque, IA"
"University of East-West Medicine"	"Sunnyvale, CA"
"University of Evansville"	"Evansville, IN"
"The University of Findlay"	"Findlay, OH"
"University of Georgia"	"Athens, GA"
"University of Hartford"	"West Hartford, CT"
"University of Hawaii at Hilo"	"Hilo, HI"
"University of Hawaii at Manoa"	"Honolulu, HI"
"University of Hawaii Maui College"	"Kahului, HI"
"University of Hawaii-West Oahu"	"Pearl City, HI"
"University of Holy Cross"	"New Orleans, LA"
"University of Houston"	"Houston, TX"
"University of Houston - Clear Lake"	"Houston, TX"
"University of Houston-Downtown"	"Houston, TX"
"University of Idaho"	"Moscow, ID"
"University of Illinois Urbana - Champaign"	"Champaign, IL"
"University of Indianapolis"	"Indianapolis, IN"
"University of Iowa"	"Iowa City, IA"
"University of Jamestown"	"Jamestown, ND"
"University of Kansas"	"Lawrence, KS"
"University of La Verne"	"La Verne, CA"
"University of Louisville"	"Louisville, KY"
"University of Lynchburg"	"Lynchburg, VA"
"University of Maine"	"Orono, ME"
"University of Maine at Augusta"	"Augusta, ME"
"University of Maine at Farmington"	"Farmington, ME"
"University of Maine at Fort Kent"	"Fort Kent, ME"
"University of Maine at Machias"	"Machias, ME"
"University of Maine at Presque Isle"	"Presque Isle, ME"
"University of Management and Technology"	"Arlington, VA"
"University of Mary"	"Bismarck, ND"
"University of Mary Hardin-Baylor"	"Belton, TX"
"University of Mary Washington"	"Fredericksburg, VA"
"University of Maryland - Baltimore"	"Baltimore, MD"
"University of Maryland - College Park"	"College Park, MD"
"University of Maryland Eastern Shore"	"Princess Anne, MD"
"University of Maryland Global Campus"	"Adelphi, MD"
"University of Maryland, Baltimore County"	"Baltimore, MD"
"University of Massachusetts - Amherst"	"Amherst, MA"
"University of Massachusetts - Dartmouth"	"North Dartmouth, MA"
"University of Massachusetts - Lowell"	"Lowell, MA"
"University of Massachusetts Medical School Worcester"	"Worcester, MA"
"University of Massachusetts-Boston"	"Boston, MA"
"University of Memphis"	"Memphis, TN"
"University of Miami"	"Coral Gables, FL"
"University of Michigan - Ann Arbor"	"Ann Arbor, MI"
"University of Michigan - Dearborn"	"Dearborn, MI"
"University of Michigan - Flint"	"Flint, MI"
"University of Minnesota-Crookston"	"Crookston, MN"
"University of Minnesota-Duluth"	"Duluth, MN"
"University of Minnesota-Morris"	"Morris, MN"
"University of Minnesota-Rochester"	"Rochester, MN"
"University of Minnesota-Twin Cities"	"Minneapolis, MN"
"University of Mississippi"	"Oxford, MS"
"University of Mississippi Medical Center"	"Jackson, MS"
"University of Missouri"	"Columbia, MO"
"University of Missouri - Kansas City"	"Kansas City, MO"
"University of Missouri at Saint Louis"	"St. Louis, MO"
"University of Mobile"	"Mobile, AL"
"The University of Montana-Western"	"Dillon, MT"
"University of Montevallo"	"Montevallo, AL"
"University of Mount Union"	"Alliance, OH"
"University of Nebraska - Lincoln"	"Lincoln, NE"
"University of Nebraska at Kearney"	"Kearney, NE"
"University of Nebraska at Omaha"	"Omaha, NE"
"University of Nebraska Medical Center"	"Omaha, NE"
"University of Nevada at Las Vegas"	"Las Vegas, NV"
"University of New England"	"Biddeford, ME"
"University of New Hampshire at Manchester"	"Manchester, NH"
"University of New Hampshire School of Law"	"Concord, NH"
"University of New Hampshire-Main Campus"	"Durham, NH"
"University of New Haven"	"West Haven, CT"
"University of New Mexico-Gallup Campus"	"Gallup, NM"
"University of New Mexico-Los Alamos Campus"	"Los Alamos, NM"
"University of New Mexico-Taos Campus"	"Ranchos de Taos, NM"
"University of New Mexico-Valencia County Campus"	"Los Lunas, NM"
"University of New Orleans"	"New Orleans, LA"
"University of North Alabama"	"Florence, AL"
"University of North Carolina at Asheville"	"Asheville, NC"
"University of North Carolina at Chapel Hill"	"Chapel Hill, NC"
"University of North Carolina at Charlotte"	"Charlotte, NC"
"University of North Carolina at Greensboro"	"Greensboro, NC"
"University of North Georgia"	"Dahlonega, GA"
"University of North Texas"	"Denton, TX"
"University of North Texas Health Science Center"	"Fort Worth, TX"
"University of Northern Iowa"	"Cedar Falls, IA"
"University of Northwestern - St. Paul"	"Saint Paul, MN"
"University of Oklahoma - Norman Campus"	"Norman, OK"
"University of Oklahoma Health Sciences Center"	"Oklahoma City, OK"
"University of Oregon"	"Eugene, OR"
"University of Pennsylvania"	"Philadelphia, PA"
"University of Pikeville"	"Pikeville, KY"
"University of Pittsburgh Medical Center-Shadyside School of Nursing"	"Pittsburgh, PA"
"University of Pittsburgh-Bradford"	"Bradford, PA"
"University of Pittsburgh-Greensburg"	"Greensburg, PA"
"University of Pittsburgh-Johnstown"	"Johnstown, PA"
"University of Pittsburgh-Pittsburgh Campus"	"Pittsburgh, PA"
"University of Pittsburgh-Titusville"	"Titusville, PA"
"University of Portland"	"Portland, OR"
"University of Providence"	"Great Falls, MT"
"University of Puget Sound"	"Tacoma, WA"
"University of Rhode Island"	"Kingston, RI"
"University of Richmond"	"Richmond, VA"
"University of Rio Grande"	"Rio Grande, OH"
"University of Rochester"	"Rochester, NY"
"University of Saint Joseph - CT"	"West Hartford, CT"
"University of San Diego"	"San Diego, CA"
"University of Science and Arts of Oklahoma"	"Chickasha, OK"
"University of Sioux Falls"	"Sioux Falls, SD"
"University of South Alabama"	"Mobile, AL"
"University of South Dakota"	"Vermillion, SD"
"University of South Florida - Sarasota-Manatee"	"Sarasota, FL"
"University of South Florida - St Petersburg"	"St. Petersburg, FL"
"University of Southern California"	"Los Angeles, CA"
"University of Southern Mississippi"	"Hattiesburg, MS"
"University of Spa & Cosmetology Arts"	"Springfield, IL"
"University of St Augustine for Health Sciences"	"St. Augustine, FL"
"University of St. Francis"	"Joliet, IL"
"University of St. Thomas"	"Saint Paul, MN"
"University of St. Thomas - TX"	"Houston, TX"
"The University of Tampa"	"Tampa, FL"
"The University of Tennessee - Chattanooga"	"Chattanooga, TN"
"The University of Tennessee - Health Science Center"	"Memphis, TN"
"The University of Tennessee - Knoxville"	"Knoxville, TN"
"The University of Tennessee - Martin"	"Martin, TN"
"The University of Texas - Rio Grande Valley"	"Edinburg, TX"
"The University of Texas at Dallas"	"Richardson, TX"
"The University of Texas at San Antonio"	"San Antonio, TX"
"The University of Texas Health Science Center at Houston"	"Houston, TX"
"The University of Texas Health Science Center at San Antonio"	"San Antonio, TX"
"The University of Texas M.D.  Anderson Cancer Center"	"Houston, TX"
"The University of Texas Medical Branch"	"Galveston, TX"
"The University of Texas Southwestern Medical Center"	"Dallas, TX"
"The University of the Arts"	"Philadelphia, PA"
"University of the Cumberlands"	"Williamsburg, KY"
"University of the District of Columbia"	"Washington D.C., DC"
"University of the Incarnate Word"	"San Antonio, TX"
"University of the Ozarks"	"Clarksville, AR"
"University of the Sciences"	"Philadelphia, PA"
"University of the West"	"Rosemead, CA"
"University of Toledo"	"Toledo, OH"
"University of Tulsa"	"Tulsa, OK"
"University of Utah"	"Salt Lake City, UT"
"University of Valley Forge"	"Phoenixville, PA"
"University of Vermont"	"Burlington, VT"
"The University of Virginia's College at Wise"	"Wise, VA"
"University of Washington - Bothell"	"Bothell, WA"
"University of Washington - Seattle"	"Seattle, WA"
"University of Washington - Tacoma"	"Tacoma, WA"
"University of West Alabama"	"Livingston, AL"
"University of West Georgia"	"Carrollton, GA"
"University of Western States"	"Portland, OR"
"University of Wisconsin - Eau Claire"	"Eau Claire, WI"
"University of Wisconsin - Green Bay"	"Green Bay, WI"
"University of Wisconsin - Madison"	"Madison, WI"
"University of Wisconsin - Oshkosh"	"Oshkosh, WI"
"University of Wisconsin - Platteville"	"Platteville, WI"
"University of Wisconsin - River Falls"	"River Falls, WI"
"University of Wisconsin - Stout"	"Menomonie, WI"
"University of Wisconsin - Whitewater"	"Whitewater, WI"
"University of Wisconsin-La Crosse"	"La Crosse, WI"
"University of Wisconsin-Milwaukee"	"Milwaukee, WI"
"University of Wisconsin-Stevens Point"	"Stevens Point, WI"
"University of Wyoming"	"Laramie, WY"
"Upper Iowa University"	"Fayette, IA"
"Upper Valley Joint Vocational School"	"Piqua, OH"
"Upstate Medical University"	"Syracuse, NY"
"Urban College of Boston"	"Boston, MA"
"Ursinus College"	"Collegeville, PA"
"Ursuline College"	"Pepper Pike, OH"
"Utah State University"	"Logan, UT"
"Utah Tech University"	"St. George, UT"
"Utah Valley University"	"Orem, UT"
"Valdosta State University"	"Valdosta, GA"
"Valley City State University"	"Valley City, ND"
"Valley Forge Military College"	"Wayne, PA"
"Valley Grande Institute for Academic Studies"	"Weslaco, TX"
"Valley Medical College"	"Salem, OR"
"Valparaiso University"	"Valparaiso, IN"
"Vanderbilt University"	"Nashville, TN"
"VanderCook College of Music"	"Chicago, IL"
"Vanguard College of Cosmetology-Metairie"	"Metairie, LA"
"Vanguard University"	"Costa Mesa, CA"
"Vantage Career Center"	"Van Wert, OH"
"Vassar College"	"Poughkeepsie, NY"
"Vaughn College of Aeronautics and Technology"	"Flushing, NY"
"Veeb Nassau County School of Practical Nursing"	"Uniondale, NY"
"Ventura Adult and Continuing Education"	"Ventura, CA"
"Ventura College"	"Ventura, CA"
"Venus Beauty Academy"	"Sharon Hill, PA"
"Vermilion Community College"	"Ely, MN"
"Vermont College of Fine Arts"	"Montpelier, VT"
"Vermont Law School"	"South Royalton, VT"
"Vermont Technical College"	"Randolph Center, VT"
"Vernon College"	"Vernon, TX"
"Verve College"	"Oak Brook, IL"
"Victor Valley College"	"Victorville, CA"
"Victoria College"	"Victoria, TX"
"Villa Maria College"	"Buffalo, NY"
"Vincennes University"	"Vincennes, IN"
"Virginia Commonwealth University"	"Richmond, VA"
"Virginia Highlands Community College"	"Abingdon, VA"
"Virginia Military Institute"	"Lexington, VA"
"Virginia Polytechnic Institute and State University"	"Blacksburg, VA"
"Virginia School of Hair Design"	"Hampton, VA"
"Virginia State University"	"Petersburg, VA"
"Virginia Union University"	"Richmond, VA"
"Virginia University of Lynchburg"	"Lynchburg, VA"
"Virginia Western Community College"	"Roanoke, VA"
"Visible Music College"	"Memphis, TN"
"Viterbo University"	"La Crosse, WI"
"Volunteer State Community College"	"Gallatin, TN"
"Voorhees College"	"Denmark, SC"
"W Academy of Salon and Spa"	"Danville, CA"
"Wabash College"	"Crawfordsville, IN"
"Wabash Valley College"	"Mount Carmel, IL"
"Wade College"	"Dallas, TX"
"Wagner College"	"Staten Island, NY"
"Walla Walla Community College"	"Walla Walla, WA"
"Wallace State Community College - Hanceville"	"Hanceville, AL"
"Wallace State Community College-Dothan"	"Dothan, AL"
"Wallace State Community College-Selma"	"Selma, AL"
"Walsh College of Accountancy and Business Administration"	"Troy, MI"
"Warner Pacific College"	"Portland, OR"
"Warner Pacific College Adult Degree Program"	"Portland, OR"
"Warner University"	"Lake Wales, FL"
"Warren County Career Center"	"Lebanon, OH"
"Warren County Community College"	"Washington, NJ"
"Warren Wilson College"	"Swannanoa, NC"
"Wartburg College"	"Waverly, IA"
"Washburn Institute of Technology"	"Topeka, KS"
"Washburn University"	"Topeka, KS"
"Washington & Jefferson College"	"Washington, PA"
"Washington Adventist University"	"Takoma Park, MD"
"Washington and Lee University"	"Lexington, VA"
"Washington College"	"Chestertown, MD"
"Washington County Career Center-Adult Technical Training"	"Marietta, OH"
"Washington County Community College"	"Calais, ME"
"Washington Hospital School of Nursing"	"Washington, PA"
"Washington State Community College"	"Marietta, OH"
"Washington State University"	"Pullman, WA"
"Washington University in St. Louis"	"St. Louis, MO"
"Washington-Holmes Technical Center"	"Chipley, FL"
"Washtenaw Community College"	"Ann Arbor, MI"
"Watkins College of Art Design & Film"	"Nashville, TN"
"Watts School of Nursing"	"Durham, NC"
"Waukesha County Technical College"	"Pewaukee, WI"
"Wayland Baptist University"	"Plainview, TX"
"Wayne Community College"	"Goldsboro, NC"
"Wayne County Schools Career Center"	"Smithville, OH"
"Wayne Finger Lakes BOCES-School of Practical Nursing"	"Newark, NY"
"Wayne State College"	"Wayne, NE"
"Wayne State University"	"Detroit, MI"
"Waynesburg University"	"Waynesburg, PA"
"Weatherford College"	"Weatherford, TX"
"Webber International University"	"Babson Park, FL"
"Weber State University"	"Ogden, UT"
"Webster University"	"St. Louis, MO"
"Weill Cornell Medical College"	"New York, NY"
"Welch College"	"Nashville, TN"
"Wellesley College"	"Wellesley, MA"
"Wells College"	"Aurora, NY"
"Wenatchee Valley College"	"Wenatchee, WA"
"Wentworth Institute of Technology"	"Boston, MA"
"Wes Watkins Technology Center"	"Wetumka, OK"
"Wesleyan College"	"Macon, GA"
"Wesleyan University"	"Middletown, CT"
"West Chester University of Pennsylvania"	"West Chester, PA"
"West Coast Ultrasound Institute"	"Beverly Hills, CA"
"West Georgia Technical College"	"Waco, GA"
"West Hills College Coalinga"	"Coalinga, CA"
"West Hills College Lemoore"	"Lemoore, CA"
"West Liberty University"	"West Liberty, WV"
"West Los Angeles College"	"Culver City, CA"
"West Michigan College of Barbering and Beauty LLC"	"Kalamazoo, MI"
"West Shore Community College"	"Scottville, MI"
"West Texas A&M University"	"Canyon, TX"
"West Valley College"	"Saratoga, CA"
"West Virginia Northern Community College"	"Wheeling, WV"
"West Virginia School of Osteopathic Medicine"	"Lewisburg, WV"
"West Virginia State University"	"Institute, WV"
"West Virginia University at Parkersburg"	"Parkersburg, WV"
"West Virginia University Institute of Technology"	"Montgomery, WV"
"West Virginia Wesleyan College"	"Buckhannon, WV"
"Westchester School of Beauty Culture"	"Mount Vernon, NY"
"Western Area Career and Technology Center"	"Canonsburg, PA"
"Western Carolina University"	"Cullowhee, NC"
"Western Connecticut State University"	"Danbury, CT"
"Western Dakota Technical Institute"	"Rapid City, SD"
"Western Illinois University"	"Macomb, IL"
"Western Iowa Tech Community College"	"Sioux City, IA"
"Western Kentucky University"	"Bowling Green, KY"
"Western Michigan University"	"Kalamazoo, MI"
"Western Michigan University Cooley Law School"	"Lansing, MI"
"Western Nebraska Community College"	"Scottsbluff, NE"
"Western Nevada College"	"Carson City, NV"
"Western New England University"	"Springfield, MA"
"Western New Mexico University"	"Silver City, NM"
"Western Oklahoma State College"	"Altus, OK"
"Western Oregon University"	"Monmouth, OR"
"Western Piedmont Community College"	"Morganton, NC"
"Western Seminary"	"Portland, OR"
"Western State Colorado University"	"Gunnison, CO"
"Western Suffolk BOCES"	"Northport, NY"
"Western Technical College - TX"	"El Paso, TX"
"Western Technology Center"	"Burns Flat, OK"
"Western Texas College"	"Snyder, TX"
"Western University of Health Sciences"	"Pomona, CA"
"Western Washington University"	"Bellingham, WA"
"Western Wyoming Community College"	"Rock Springs, WY"
"Westfield State University"	"Westfield, MA"
"Westminster College - MO"	"Fulton, MO"
"Westminster College - PA"	"New Wilmington, PA"
"Westminster College - UT"	"Salt Lake City, UT"
"Westminster Theological Seminary"	"Glenside, PA"
"Westmont College"	"Santa Barbara, CA"
"Westmoreland County Community College"	"Youngwood, PA"
"Westside Tech"	"Winter Garden, FL"
"Wharton County Junior College"	"Wharton, TX"
"Whatcom Community College"	"Bellingham, WA"
"Wheaton College - IL"	"Wheaton, IL"
"Wheaton College - MA"	"Norton, MA"
"Wheeling University"	"Wheeling, WV"
"Wheelock College"	"Boston, MA"
"White Mountains Community College"	"Berlin, NH"
"Whitman College"	"Walla Walla, WA"
"Whittier College"	"Whittier, CA"
"Whitworth University"	"Spokane, WA"
"Whitworth University-Adult Degree Programs"	"Spokane, WA"
"Wichita State University"	"Wichita, KS"
"Wichita State University Tech"	"Wichita, KS"
"Wilberforce University"	"Wilberforce, OH"
"Wiley College"	"Marshall, TX"
"Wilkes Community College"	"Wilkesboro, NC"
"Wilkes-Barre Area Career and Technical Center Practical Nursing"	"Wilkes Barre, PA"
"Willamette University"	"Salem, OR"
"William James College"	"Boston, MA"
"William Jessup University"	"Rocklin, CA"
"William Jewell College"	"Liberty, MO"
"William Moore College of Technology"	"Memphis, TN"
"William Peace University"	"Raleigh, NC"
"William Penn University"	"West Des Moines, IA"
"William Woods University"	"Fulton, MO"
"Williams Baptist College"	"Walnut Ridge, AR"
"Williams College"	"Williamstown, MA"
"Williamsburg Technical College"	"Kingstree, SC"
"Williston State College"	"Williston, ND"
"Wilmington College"	"Wilmington, OH"
"Wilmington University"	"New Castle, DE"
"Wilson College"	"Chambersburg, PA"
"Wilson Community College"	"Wilson, NC"
"Windward Community College"	"Kaneohe, HI"
"Wingate University"	"Wingate, NC"
"Winona State University"	"Winona, MN"
"Winston-Salem State University"	"Winston-Salem, NC"
"Winter Park Tech"	"Winter Park, FL"
"Wisconsin Indianhead Technical College"	"Shell Lake, WI"
"Withlacoochee Technical Institute"	"Inverness, FL"
"Wittenberg University"	"Springfield, OH"
"Wofford College"	"Spartanburg, SC"
"Woodbury University"	"Burbank, CA"
"Woodland Community College"	"Woodland, CA"
"Woodruff Medical Training and Testing"	"Decatur, GA"
"Wor-Wic Community College"	"Salisbury, MD"
"World Mission University"	"Los Angeles, CA"
"The Wright Institute"	"Berkeley, CA"
"Wright State University-Lake Campus"	"Celina, OH"
"Wytheville Community College"	"Wytheville, VA"
"Xavier College School of Nursing"	"Stockton, CA"
"Xavier University"	"Cincinnati, OH"
"Xavier University of Louisiana"	"New Orleans, LA"
"Xcell Academy-A Paul Mitchell Partner School"	"Hoover, AL"
"Yale University"	"New Haven, CT"
"Yeshiva University"	"New York, NY"
"Yo San University of Traditional Chinese Medicine"	"Los Angeles, CA"
"York College"	"York, NE"
"York College of Pennsylvania"	"York, PA"
"York County Community College"	"Wells, ME"
"York County School of Technology Practical Nursing"	"York, PA"
"York Technical College"	"Rock Hill, SC"
"Young Harris College"	"Young Harris, GA"
"Yuba College"	"Marysville, CA"
"Zane State College"	"Zanesville, OH"
